,NAME,M5,M5-9,M10-14,M15-17,W5,W5-9,W10-14,W15-17,state,county,fips,male_le_30,male_ge_30_le_45,male_ge_45_le_65,male_ge_65,female_le_30,female_ge_30_le_45,female_ge_45_le_65,female_ge_65,age_le_30,age_ge_30_le_45,age_ge_45_le_65,age_ge_65,total,male,female,white,black,aapi,other_race_alone,hispanic,median_income,bachelor_or_higher,total_votes_2016,total_votes_2020
0,"Fayette County, Illinois",11469,621,621,417,564,497,711,387,17,51,17051,1886,2221,3203,1864,1327,1700,2716,2194,3213,3921,5919,4058,21565,11469,10096,20245,1007,116,13,403,46650,4016,9585.0,10033.0
1,"Logan County, Illinois",14298,828,757,544,725,718,784,503,17,107,17107,2417,2888,3868,2248,2588,2673,3738,2976,5005,5561,7606,5224,29003,14298,14705,25667,2003,218,230,985,57308,5742,12401.0,13117.0
2,"Saline County, Illinois",11807,798,612,546,700,571,774,392,17,165,17165,1672,2058,3215,2103,1588,2076,3404,2682,3260,4134,6619,4785,23994,11807,12187,22234,632,178,122,428,44090,3859,11384.0,11079.0
3,"Lake County, Illinois",350466,20725,24406,16798,19978,22550,25428,15928,17,97,17097,60125,63352,95795,43532,50870,63929,99517,52807,110995,127281,195312,96339,701473,350466,351007,531609,47385,54157,45309,152141,89427,159690,303520.0,254827.0
4,"Massac County, Illinois",6714,388,516,247,403,712,325,269,17,127,17127,899,1167,1885,1268,860,1271,1971,1694,1759,2438,3856,2962,14219,6714,7505,12956,830,29,0,419,47481,2386,6683.0,6803.0
5,"Cass County, Illinois",6236,377,510,287,433,420,364,229,17,17,17017,863,1136,1668,972,847,1127,1653,1184,1710,2263,3321,2156,12493,6236,6257,11058,652,45,581,2362,52373,2535,5124.0,5325.0
6,"Huntington County, Indiana",17919,996,1123,698,1042,1008,1168,659,18,69,18069,2943,3329,5032,2661,2817,3151,5128,3467,5760,6480,10160,6128,36359,17919,18440,34850,357,263,420,894,53632,7636,16043.0,17809.0
7,"White County, Indiana",12063,772,889,504,718,808,779,449,18,181,18181,1688,1942,3361,2176,1519,1911,3367,2535,3207,3853,6728,4711,24149,12063,12086,21955,123,55,1518,2021,54576,4786,10053.0,10402.0
8,"Jay County, Indiana",10452,785,798,468,674,531,813,468,18,75,18075,1611,1655,2802,1591,1441,1667,2770,2024,3052,3322,5572,3615,20840,10452,10388,20212,76,157,162,647,47658,4312,7986.0,8466.0
9,"Shelby County, Indiana",21874,1296,1259,885,1238,1206,1680,881,18,145,18145,3134,3949,6336,3326,2994,3993,6498,4074,6128,7942,12834,7400,44438,21874,22564,42110,519,250,796,1873,60404,10100,17994.0,20017.0
10,"Sullivan County, Indiana",11076,551,553,389,507,541,591,338,18,153,18153,1875,2376,3125,1600,1337,1746,2617,1977,3212,4122,5742,3577,20730,11076,9654,19254,830,106,77,360,50245,4205,8559.0,9004.0
11,"Tippecanoe County, Indiana",97798,5757,5415,3249,5559,5405,5334,3161,18,157,18157,33960,16376,18188,9273,27636,15648,18963,12049,61596,32024,37151,21322,191553,97798,93755,156081,10168,15564,4561,15948,53130,36402,62515.0,71755.0
12,"Hamilton County, Indiana",157702,10908,12254,7936,10626,11678,13497,7696,18,57,18057,20710,33721,41228,16990,20782,36392,43372,21372,41492,70113,84600,38362,323117,157702,165415,280363,12764,19336,2054,12928,98173,82528,154256.0,194447.0
13,"Bartholomew County, Indiana",41170,2846,2777,1560,2621,2993,2485,1715,18,5,18005,6991,8249,10175,5798,5986,7803,10272,7436,12977,16052,20447,13234,82481,41170,41311,70299,1549,6104,2173,5572,63431,19801,32490.0,36299.0
14,"Fulton County, Indiana",9903,612,742,400,563,824,558,404,18,49,18049,1404,1705,2738,1671,1275,1663,2778,2128,2679,3368,5516,3799,20096,9903,10193,18864,186,90,565,1045,52034,4199,8374.0,9110.0
15,"Noble County, Indiana",23872,1643,1624,1084,1487,1543,1748,1006,18,113,18113,3549,4339,6517,3263,3335,4193,6352,3970,6884,8532,12869,7233,47506,23872,23634,45774,228,314,245,4888,56789,9079,16890.0,19217.0
16,"Clark County, Indiana",56860,3782,3272,2246,3560,3701,3530,2155,18,19,18019,8641,11892,15203,7636,8702,11859,15827,10313,17343,23751,31030,17949,116507,56860,59647,102002,7854,1263,1064,6264,55630,23355,51147.0,58040.0
17,"Hendricks County, Indiana",81767,4873,5371,3799,4825,5974,5731,3727,18,63,18063,11892,17543,21628,9549,10692,17072,21732,12279,22584,34615,43360,21828,163799,81767,82032,142553,11507,4773,1565,6394,81933,35830,75559.0,88430.0
18,"Grant County, Indiana",31695,1852,1982,1223,1845,1796,2053,1169,18,53,18053,5823,4833,8694,5401,6597,5332,8960,7005,12420,10165,17654,12406,66452,31695,34757,58360,4811,653,550,2846,44356,12563,25312.0,27230.0
19,"Jackson County, Indiana",21842,1586,1455,956,1309,1583,1410,911,18,71,18071,3040,4462,5670,3102,2955,4292,5847,3876,5995,8754,11517,6978,44025,21842,22183,40013,473,983,1765,3086,51250,8908,17573.0,19238.0
20,"Owen County, Indiana",10636,559,618,429,565,531,654,417,18,119,18119,1317,1776,3373,1921,1238,1636,3129,2029,2555,3412,6502,3950,20835,10636,10199,20191,98,103,0,262,49543,4852,8557.0,9915.0
21,"Whitley County, Indiana",16755,1040,1171,718,1001,981,1159,637,18,183,18183,2354,2993,4773,2615,2159,2914,4796,3328,4513,5907,9569,5943,33730,16755,16975,32666,137,145,35,694,61741,7094,15623.0,17581.0
22,"Clinton County, Indiana",16067,1123,1289,747,1106,1284,1042,688,18,23,18023,2373,2902,4158,2294,2244,2811,4111,2920,4617,5713,8269,5214,32273,16067,16206,29558,268,113,1967,5118,54286,6020,11936.0,12961.0
23,"Union County, Indiana",3480,193,242,145,259,157,210,133,18,161,18161,539,546,1034,599,476,587,1071,740,1015,1133,2105,1339,7113,3480,3633,6898,15,145,4,126,50375,1562,3291.0,3491.0
24,"Dearborn County, Indiana",24658,1288,1766,1074,1262,1368,1759,1076,18,29,18029,3433,4271,7241,3912,3252,4326,7269,4509,6685,8597,14510,8421,49479,24658,24821,48102,431,279,137,646,68658,10765,23987.0,25302.0
25,"Lawrence County, Indiana",22485,1300,1483,928,1169,1473,1279,887,18,93,18093,3166,3873,6264,4001,2774,4084,6392,5005,5940,7957,12656,9006,45548,22485,23063,43954,180,223,167,761,53610,9036,19152.0,21071.0
26,"Perry County, Indiana",10191,543,430,336,540,559,557,331,18,123,18123,1590,2119,2773,1613,1094,1545,2430,1855,2684,3664,5203,3468,19102,10191,8911,18091,577,97,70,266,52348,4463,8055.0,8734.0
27,"Posey County, Indiana",12744,702,791,594,690,694,876,527,18,129,18129,1700,2230,3742,2139,1577,2260,3677,2515,3277,4490,7419,4654,25560,12744,12816,24599,458,84,106,305,64196,5515,12467.0,13264.0
28,"Carroll County, Indiana",10085,549,620,501,513,611,611,390,18,15,18015,1395,1724,2858,1751,1331,1707,2733,2093,2726,3431,5591,3844,20074,10085,9989,19284,234,41,367,814,54806,4113,8643.0,9514.0
29,"Fountain County, Indiana",8254,535,615,345,400,487,447,342,18,45,18045,1135,1392,2330,1438,1033,1389,2311,1767,2168,2781,4641,3205,16430,8254,8176,16023,37,72,22,414,52874,3552,7492.0,7978.0
30,"Starke County, Indiana",11422,695,698,464,601,782,734,557,18,149,18149,1613,1944,3150,1982,1507,1989,3253,2107,3120,3933,6403,4089,22952,11422,11530,22303,198,60,156,869,51190,4647,9226.0,10309.0
31,"Greene County, Indiana",15971,849,943,705,863,1015,998,655,18,55,18055,2162,2796,4653,2823,2017,2714,4548,3378,4179,5510,9201,6201,32159,15971,16188,31405,127,64,48,468,51613,6632,13801.0,14807.0
32,"Benton County, Iowa",12788,821,767,571,754,747,934,552,19,11,19011,1637,2238,3730,2118,1446,2218,3684,2513,3083,4456,7414,4631,25636,12788,12848,24852,143,85,179,386,67729,5814,13844.0,14627.0
33,"Dubuque County, Iowa",47818,3158,2986,1964,2960,3208,2856,1881,19,61,19061,8214,8487,12566,7253,7915,8115,12704,9525,16129,16602,25270,16778,96982,47818,49164,89785,3440,1050,477,2395,63031,21991,49721.0,53924.0
34,"Pocahontas County, Iowa",3318,177,196,142,184,236,191,128,19,151,19151,410,498,981,703,363,495,1041,841,773,993,2022,1544,6797,3318,3479,6527,40,91,31,260,52448,1431,3865.0,3821.0
35,"Van Buren County, Iowa",3665,227,291,181,189,250,184,136,19,177,19177,392,573,1035,755,381,544,974,827,773,1117,2009,1582,7150,3665,3485,6960,48,37,24,113,48591,1483,3561.0,3795.0
36,"Adams County, Iowa",1830,121,102,69,98,169,52,51,19,3,19003,220,289,531,393,217,279,531,443,437,568,1062,836,3670,1830,1840,3620,2,9,27,49,49255,817,2106.0,2158.0
37,"Audubon County, Iowa",2770,185,119,95,145,142,146,94,19,9,19009,318,409,830,594,333,397,784,760,651,806,1614,1354,5571,2770,2801,5401,11,15,0,32,52055,1132,3412.0,3413.0
38,"Davis County, Iowa",4403,385,358,191,420,325,396,226,19,51,19051,646,697,1101,705,551,700,1049,850,1197,1397,2150,1555,8920,4403,4517,8710,4,57,3,131,63404,1624,3882.0,4099.0
39,"Ida County, Iowa",3442,195,183,137,198,246,202,127,19,93,19093,406,569,940,681,410,530,916,830,816,1099,1856,1511,6901,3442,3459,6713,47,16,27,169,58427,1396,3612.0,3845.0
40,"Monroe County, Iowa",3886,221,307,175,217,157,380,157,19,135,19135,527,650,1087,693,473,638,1059,840,1000,1288,2146,1533,7807,3886,3921,7591,2,8,179,77,58269,1667,3865.0,4085.0
41,"Sioux County, Iowa",17485,1307,1355,847,1250,1145,1467,700,19,167,19167,3371,3117,3764,2363,3165,2986,3691,2938,6536,6103,7455,5301,34827,17485,17342,32930,122,257,813,3743,69844,6084,18194.0,18943.0
42,"Calhoun County, Iowa",5057,288,302,184,279,242,293,159,19,25,19025,726,925,1321,995,515,691,1281,1227,1241,1616,2602,2222,9744,5057,4687,9317,150,35,41,190,52323,2148,5159.0,5246.0
43,"Cerro Gordo County, Iowa",20905,1143,1083,805,1163,1101,1328,697,19,33,19033,3096,3638,5772,3875,2903,3374,6195,5168,5999,7012,11967,9043,42834,20905,21929,40288,747,491,249,2086,53963,8677,22965.0,23794.0
44,"Hardin County, Iowa",8522,403,565,522,438,482,431,315,19,83,19083,1207,1440,2381,1578,1022,1348,2447,2056,2229,2788,4828,3634,17061,8522,8539,16212,221,13,93,743,54196,3751,8533.0,8962.0
45,"Lucas County, Iowa",4317,271,292,195,236,199,320,177,19,117,19117,565,626,1215,855,502,667,1184,981,1067,1293,2399,1836,8583,4317,4266,8505,8,0,34,172,55205,1834,4354.0,4299.0
46,"Palo Alto County, Iowa",4468,328,311,181,278,283,326,142,19,147,19147,629,774,1130,834,577,687,1138,1104,1206,1461,2268,1938,9003,4468,4535,8625,214,30,24,253,52932,1782,4703.0,4948.0
47,"Henry County, Iowa",10133,545,646,399,564,566,690,373,19,87,19087,1601,2054,2674,1637,1469,1604,2503,2039,3070,3658,5177,3676,19941,10133,9808,18273,444,526,135,974,53501,4377,9404.0,9929.0
48,"Jasper County, Iowa",18879,1146,1222,718,1019,1018,1358,691,19,99,19099,2701,3716,5206,3067,2142,3010,4932,3922,4843,6726,10138,6989,36971,18879,18092,35232,738,172,115,867,58952,8202,19034.0,20653.0
49,"Poweshiek County, Iowa",8839,440,485,331,459,492,550,309,19,157,19157,1743,1408,2263,1639,1919,1360,2384,2076,3662,2768,4647,3715,18388,8839,9549,17261,354,391,94,589,53852,4272,9833.0,10120.0
50,"Clayton County, Iowa",8946,470,669,351,479,595,439,293,19,43,19043,1056,1358,2656,1924,1003,1262,2487,2121,2059,2620,5143,4045,17625,8946,8679,17173,170,79,56,339,53152,4288,9129.0,9589.0
51,"Bremer County, Iowa",12313,787,723,551,678,748,756,451,19,17,19017,2071,2128,2987,2222,2128,2097,3049,2644,4199,4225,6036,4866,24864,12313,12551,23895,228,286,60,392,70395,5460,13538.0,14534.0
52,"Emmet County, Iowa",4728,278,213,149,228,247,268,231,19,63,19063,760,768,1354,861,637,756,1267,1076,1397,1524,2621,1937,9438,4728,4710,8929,199,24,112,920,51563,1848,4753.0,4850.0
53,"Hancock County, Iowa",5418,302,383,237,304,265,377,207,19,81,19081,663,939,1491,1090,637,852,1474,1268,1300,1791,2965,2358,10802,5418,5384,10430,172,53,54,476,61761,2447,5871.0,6164.0
54,"Jackson County, Iowa",9713,594,677,394,564,546,640,386,19,97,19097,1260,1621,2854,1802,1111,1469,2817,2155,2371,3090,5671,3957,19401,9713,9688,18781,92,79,19,285,55967,4631,10310.0,11118.0
55,"Lee County, Iowa",17263,1026,1041,680,1025,1030,958,602,19,111,19111,2421,3035,4944,3030,2144,2697,4733,3775,4565,5732,9677,6805,34227,17263,16964,32054,946,213,181,1237,49564,7072,16151.0,16721.0
56,"Warren County, Iowa",24497,1459,2094,1167,1545,1690,1766,1057,19,181,19181,3637,4716,6354,3425,3731,4720,6714,4356,7368,9436,13068,7781,50076,24497,25579,48092,260,348,347,1423,77048,10739,27300.0,30955.0
57,"Mahaska County, Iowa",11148,784,757,476,687,812,596,396,19,123,19123,1725,1942,2857,1799,1505,1939,2875,2206,3230,3881,5732,4005,22164,11148,11016,21112,312,342,1,496,54825,4881,10632.0,11346.0
58,"Clay County, Iowa",7998,576,516,291,482,487,526,309,19,41,19041,1060,1368,2237,1476,981,1418,2157,1853,2041,2786,4394,3329,16211,7998,8213,15446,112,105,141,598,50521,3218,8617.0,8928.0
59,"Delaware County, Iowa",8626,551,708,385,578,406,680,342,19,55,19055,1059,1384,2539,1530,968,1339,2498,1746,2027,2723,5037,3276,17183,8626,8557,16760,36,63,76,267,63750,3794,9241.0,9981.0
60,"Bacon County, Georgia",5473,347,419,245,448,430,313,232,13,5,13005,872,1128,1300,724,824,1118,1366,997,1696,2246,2666,1721,11201,5473,5728,8956,1701,19,171,925,37519,1963,4020.0,4668.0
61,"Brantley County, Georgia",9198,611,614,445,509,769,539,369,13,25,13025,1300,1650,2607,1369,1373,1616,2744,1639,2673,3266,5351,3008,18756,9198,9558,17610,661,201,1,419,38857,3681,6301.0,7746.0
62,"Ben Hill County, Georgia",8139,654,385,296,441,371,799,463,13,17,13017,1151,1472,2160,1156,1220,1479,2427,1694,2371,2951,4587,2850,17033,8139,8894,10163,6236,117,346,1041,32229,2395,5936.0,6560.0
63,"Burke County, Georgia",10715,785,660,502,861,565,1001,486,13,33,13033,1698,1815,2781,1456,1693,2039,3232,1928,3391,3854,6013,3384,22520,10715,11805,10988,10824,75,365,728,44151,2842,9351.0,10684.0
64,"Catoosa County, Georgia",32000,1993,1991,1505,1808,2181,2061,1432,13,47,13047,4484,6301,8363,4956,4929,6426,9334,6529,9413,12727,17697,11485,66700,32000,34700,61587,1497,878,943,2012,56235,12017,26757.0,32692.0
65,"Chattahoochee County, Georgia",6875,377,359,130,508,302,275,42,13,53,13053,3832,1290,525,110,959,755,616,228,4791,2045,1141,338,10560,6875,3685,7136,2270,382,341,1675,47096,1522,1390.0,1590.0
66,"Chattooga County, Georgia",12858,739,813,469,697,812,775,451,13,55,13055,2364,2555,3196,1893,1522,2014,3281,2402,3886,4569,6477,4295,24812,12858,11954,21271,2593,42,530,1278,36807,4038,8252.0,10050.0
67,"Columbia County, Georgia",73770,4878,5420,3523,4716,5565,5345,3284,13,73,13073,11413,15593,18321,8936,10883,16355,19839,10948,22296,31948,38160,19884,150705,73770,76935,111355,25127,5846,1635,10094,82339,32821,64743.0,80454.0
68,"Decatur County, Georgia",12823,895,820,574,895,853,992,539,13,87,13087,2179,2305,3298,1796,2009,2495,3605,2471,4188,4800,6903,4267,26682,12823,13859,14002,11225,66,1255,1623,41481,3506,10286.0,11627.0
69,"Floyd County, Georgia",47109,3005,2961,2002,2863,3156,3067,1948,13,115,13115,7933,8730,11817,6983,8538,8770,12841,9077,16471,17500,24658,16060,97369,47109,50260,76218,13576,1343,3248,10776,48336,16705,34608.0,38514.0
70,"Forsyth County, Georgia",113527,7169,9102,6002,6689,8907,9614,5719,13,117,13117,13255,24044,31566,11982,12742,25667,30831,14687,25997,49711,62397,26669,228383,113527,114856,180891,8013,29535,3900,21686,107218,57804,98221.0,129237.0
71,"Habersham County, Georgia",21134,1369,1315,901,1237,1164,1652,883,13,137,13137,3310,3625,5350,3767,3820,4254,6004,4478,7130,7879,11354,8245,44626,21134,23492,38434,1435,864,2548,6599,50563,7854,16243.0,20407.0
72,"Hart County, Georgia",12664,673,815,442,696,681,864,390,13,147,13147,1854,2114,3486,2512,1605,2282,3475,3116,3459,4396,6961,5628,25773,12664,13109,19950,4998,255,150,940,43204,4285,10117.0,12727.0
73,"Lowndes County, Georgia",56144,4161,3969,2189,3996,3922,3675,2002,13,185,13185,14633,10287,11316,5821,14535,10536,12672,7882,29168,20823,23988,13703,115364,56144,59220,65740,42096,2011,2180,6535,42441,16983,37805.0,46355.0
74,"McIntosh County, Georgia",7128,322,281,275,154,378,268,170,13,191,13191,865,918,2198,1738,854,1041,2280,1901,1719,1959,4478,3639,14174,7128,7046,8826,5036,189,0,40,49504,2331,5903.0,6700.0
75,"Meriwether County, Georgia",10234,655,535,445,599,543,682,360,13,199,13199,1520,1689,2832,1803,1498,1786,3016,2388,3018,3475,5848,4191,21106,10234,10872,12102,8426,52,307,464,37121,3144,9217.0,10877.0
76,"Monroe County, Georgia",13586,768,652,589,566,653,991,442,13,207,13207,2076,2465,3837,2235,1780,2376,4104,2673,3856,4841,7941,4908,27171,13586,13585,20035,6304,247,279,631,54754,5127,12687.0,15592.0
77,"Putnam County, Georgia",10510,498,577,440,488,874,532,309,13,237,13237,1297,1644,2875,2471,1346,1779,3223,2630,2643,3423,6098,5101,21691,10510,11181,14970,5689,133,620,1378,51606,3875,9488.0,11855.0
78,"Sumter County, Georgia",14197,969,1214,620,881,967,1020,518,13,261,13261,2882,2396,3275,2109,3129,2582,3865,2905,6011,4978,7140,5014,30064,14197,15867,12836,15712,410,601,1711,36681,3928,10974.0,12150.0
79,"Taliaferro County, Georgia",793,8,20,51,46,25,65,5,13,265,13265,144,200,178,171,102,138,202,235,246,338,380,406,1611,793,818,547,1000,12,48,64,37446,185,897.0,928.0
80,"Warren County, Georgia",2469,125,203,68,154,193,147,97,13,301,13301,354,409,711,484,360,414,804,659,714,823,1515,1143,5297,2469,2828,1986,3237,32,4,25,37203,729,2334.0,2681.0
81,"Wayne County, Iowa",3168,236,213,130,225,233,221,134,19,185,19185,390,503,852,618,399,470,802,777,789,973,1654,1395,6429,3168,3261,6250,19,6,29,102,44768,1330,2940.0,3103.0
82,"Scott County, Iowa",84605,5609,6124,3493,5486,5651,5851,3343,19,163,19163,12788,16839,22060,12102,12878,16776,22766,15090,25666,33615,44826,27192,172446,84605,87841,147646,12954,4698,1290,11590,61183,36964,86220.0,92639.0
83,"Sherman County, Kansas",3086,254,107,133,141,221,128,94,20,181,20181,475,544,745,503,344,682,631,611,819,1226,1376,1114,5938,3086,2852,5392,114,55,224,722,54754,1198,2612.0,2669.0
84,"Thomas County, Kansas",3773,320,216,128,243,269,202,136,20,193,20193,711,656,922,561,838,634,1000,715,1549,1290,1922,1276,7810,3773,4037,7328,177,72,120,510,60124,1379,3576.0,5422.0
85,"Morris County, Kansas",2773,173,175,89,144,115,234,111,20,127,20127,315,469,758,633,265,403,799,722,580,872,1557,1355,5566,2773,2793,5347,11,33,12,279,55658,1243,2624.0,2849.0
86,"Rooks County, Kansas",2428,151,163,91,172,118,205,108,20,163,20163,315,421,685,493,290,401,706,625,605,822,1391,1118,5053,2428,2625,4860,89,4,14,127,49415,1053,2419.0,2666.0
87,"Clark County, Kansas",1050,84,90,46,73,64,50,24,20,25,20025,114,142,268,236,108,144,271,242,222,286,539,478,2026,1050,976,1917,10,23,10,112,53348,413,1005.0,1048.0
88,"Harper County, Kansas",2846,190,203,132,194,196,142,87,20,77,20077,366,464,719,537,297,424,700,708,663,888,1419,1245,5594,2846,2748,5356,10,22,14,343,49865,1094,2578.0,2628.0
89,"Lyon County, Kansas",16107,981,1224,547,981,918,1124,664,20,111,20111,3738,2677,3764,2168,4269,2630,3816,2742,8007,5307,7580,4910,33251,16107,17144,29661,763,710,466,7059,46338,6094,12288.0,13622.0
90,"Pawnee County, Kansas",3670,112,183,175,209,198,83,148,20,145,20145,563,782,1138,601,341,452,785,743,904,1234,1923,1344,6629,3670,2959,5941,308,4,124,511,49917,1510,2661.0,2712.0
91,"Comanche County, Kansas",926,31,75,48,36,27,43,37,20,33,20033,86,149,216,232,50,128,271,222,136,277,487,454,1740,926,814,1725,4,0,8,66,54821,364,867.0,900.0
92,"Gove County, Kansas",1330,88,115,24,69,65,75,46,20,63,20063,133,197,368,319,175,171,330,383,308,368,698,702,2644,1330,1314,2532,14,14,0,90,48317,566,1343.0,1433.0
93,"Harvey County, Kansas",17159,1086,851,891,1053,1076,1152,776,20,79,20079,2706,2905,4215,2927,2454,2885,4260,3688,5160,5790,8475,6615,34503,17159,17344,32126,574,218,349,4101,57982,6680,14916.0,17120.0
94,"Kearny County, Kansas",1860,111,148,92,201,194,127,93,20,93,20093,322,288,511,231,296,344,451,341,618,632,962,572,3907,1860,2047,3694,101,15,71,1239,52599,686,1316.0,1413.0
95,"McPherson County, Kansas",14070,785,1064,570,824,658,1151,654,20,113,20113,2284,2395,3735,2428,1995,2382,3688,3145,4279,4777,7423,5573,28567,14070,14497,27274,331,193,30,1205,59089,5329,12742.0,13901.0
96,"Desha County, Arkansas",5562,404,388,248,344,360,470,275,5,41,05041,762,864,1431,954,846,1018,1601,1233,1608,1882,3032,2187,11709,5562,6147,5710,5456,51,242,718,31893,1579,4257.0,4163.0
97,"Fulton County, Arkansas",6106,309,386,265,294,357,347,213,5,49,05049,753,885,1676,1477,635,874,1760,1645,1388,1759,3436,3122,12231,6106,6125,11736,58,8,68,196,35405,2226,4772.0,5098.0
98,"Howard County, Arkansas",6388,380,497,356,552,284,540,323,5,61,05061,835,1089,1662,1044,968,1281,1673,1302,1803,2370,3335,2346,13311,6388,6923,8967,2779,36,1174,1669,36059,1894,4674.0,4818.0
99,"Garland County, Arkansas",47295,2737,3250,1744,2523,2941,2595,1843,5,51,05051,6555,7818,12586,10269,6406,8557,13664,12731,12961,16375,26250,23000,98555,47295,51260,84807,8092,588,1453,5553,44777,18361,40805.0,44193.0
100,"Mississippi County, Arkansas",20436,1566,1503,999,1471,1385,1676,955,5,93,05093,3425,3676,5067,2661,3317,3962,5497,3427,6742,7638,10564,6088,42126,20436,21690,25411,14212,238,850,1740,39962,6164,13204.0,12287.0
101,"Pope County, Arkansas",31330,1982,2015,962,2002,2248,1735,1342,5,115,05115,6610,5397,7753,4297,6613,5292,7764,5435,13223,10689,15517,9732,63761,31330,32431,58162,1909,658,981,5751,43462,11783,22569.0,24367.0
102,"Prairie County, Arkansas",4095,253,174,158,189,244,170,125,5,117,05117,513,634,1137,895,471,669,1206,1020,984,1303,2343,1915,8189,4095,4094,7020,1017,17,54,142,42660,1664,3444.0,3465.0
103,"Union County, Arkansas",19101,1248,1488,794,1383,1195,1391,758,5,139,05139,2758,3404,5133,3006,2695,3607,5521,3798,5453,7011,10654,6804,39449,19101,20348,25201,12887,258,308,1577,44663,6459,16894.0,16548.0
104,"Woodruff County, Arkansas",3006,156,223,49,223,260,183,151,5,147,05147,412,467,899,640,430,499,940,841,842,966,1839,1481,6533,3006,3527,4563,1839,59,0,30,32845,997,2571.0,2469.0
105,"Cleburne County, Arkansas",12434,620,754,445,559,654,704,411,5,23,05023,1506,1940,3382,3133,1254,2013,3485,3586,2760,3953,6867,6719,25100,12434,12666,24327,98,167,7,609,44483,5276,12085.0,12617.0
106,"Cleveland County, Arkansas",4007,235,212,155,187,292,266,146,5,25,05025,532,677,1109,772,484,744,1110,892,1016,1421,2219,1664,8128,4007,4121,6970,1040,0,0,101,46684,1688,3354.0,3588.0
107,"Jackson County, Arkansas",8427,428,466,292,474,492,445,284,5,67,05067,1470,1708,2199,1305,1258,1681,2285,1681,2728,3389,4484,2986,17027,8427,8600,13230,2091,8,59,492,34109,2669,5156.0,5076.0
108,"Hempstead County, Arkansas",10323,709,773,486,849,670,930,398,5,57,05057,1458,1611,2785,1704,1527,2042,2902,2201,2985,3653,5687,3905,21842,10323,11519,12523,6582,26,2081,2800,42860,3174,7049.0,6838.0
109,"Sharp County, Arkansas",8397,437,305,394,407,628,449,299,5,135,05135,976,1229,2264,2090,950,1257,2407,2345,1926,2486,4671,4435,17139,8397,8742,16284,143,14,53,391,34671,3065,7249.0,7544.0
110,"Stone County, Arkansas",6190,303,282,263,267,291,376,243,5,137,05137,757,916,1715,1544,665,834,1818,1791,1422,1750,3533,3335,12475,6190,6285,12044,11,63,1,243,38188,2274,5618.0,5919.0
111,"Washington County, Arkansas",115916,8179,8005,4656,7830,8361,7233,4485,5,143,05143,27033,23878,24239,11649,25642,23312,24698,14812,52675,47190,48937,26461,232289,115916,116373,179292,8545,5767,23215,38979,50451,42004,81861.0,93467.0
112,"Baxter County, Arkansas",20099,907,986,780,829,836,1209,609,5,5,05005,2271,2864,5191,5989,2105,2961,5989,6790,4376,5825,11180,12779,41427,20099,21328,40058,67,180,235,987,42260,8659,19766.0,20968.0
113,"Ashley County, Arkansas",9825,651,869,410,583,959,458,260,5,3,05003,1498,1479,2621,1831,1428,1723,2829,2205,2926,3202,5450,4036,20270,9825,10445,14682,5150,39,217,1101,44744,3544,8083.0,7911.0
114,"Craighead County, Arkansas",52386,3847,4159,2324,3619,3689,3431,2012,5,31,05031,10344,10560,11369,6108,10240,10861,12705,8402,20584,21421,24074,14510,107345,52386,54959,84590,15614,1510,2284,5421,47286,21520,35573.0,38364.0
115,"Greene County, Arkansas",22083,1582,1460,919,1332,1777,1380,986,5,55,05055,3580,4224,5633,3100,3339,4281,5783,3976,6919,8505,11416,7076,44937,22083,22854,42557,864,164,422,1281,47056,10048,14600.0,16066.0
116,"Perry County, Arkansas",5172,283,375,224,297,377,234,212,5,105,05105,668,860,1478,961,638,866,1458,1101,1306,1726,2936,2062,10355,5172,5183,9963,69,0,186,303,48667,2049,4306.0,4607.0
117,"Poinsett County, Arkansas",11644,796,813,538,735,704,863,448,5,111,05111,1750,2049,3098,1804,1778,2056,3216,2452,3528,4105,6314,4256,23896,11644,12252,21113,1093,12,207,727,40921,4469,7722.0,7418.0
118,"Sevier County, Arkansas",8584,789,587,412,574,639,798,391,5,133,05133,1387,1563,2062,1083,1291,1492,2023,1289,2678,3055,4085,2372,17081,8584,8497,10744,827,76,4663,5711,47704,2395,4562.0,5202.0
119,"Calhoun County, Arkansas",2609,102,123,83,155,123,123,111,5,13,05013,443,406,803,501,365,434,671,601,808,840,1474,1102,5192,2609,2583,3957,1125,0,9,207,46417,1100,2269.0,2143.0
120,"Clark County, Arkansas",10506,590,555,321,611,539,651,403,5,19,05019,2949,1539,2390,1577,3264,1670,2685,2057,6213,3209,5075,3634,22386,10506,11880,15720,5434,156,703,1059,41620,3854,8526.0,8358.0
121,"Lawrence County, Arkansas",8211,457,515,388,482,454,514,288,5,75,05075,1334,1347,2106,1433,1283,1368,2183,1766,2617,2715,4289,3199,16549,8211,8338,15992,186,25,17,256,39993,3326,5685.0,5857.0
122,"Monroe County, Arkansas",3308,206,191,109,230,250,144,128,5,95,05095,418,472,989,704,512,516,1057,905,930,988,2046,1609,7050,3308,3742,3847,3030,30,11,45,38468,1024,2884.0,2815.0
123,"Conway County, Arkansas",10154,568,600,484,686,739,621,374,5,29,05029,1457,1717,2787,1793,1326,1809,3003,2146,2783,3526,5790,3939,20858,10154,10704,17760,2167,69,39,818,42802,4228,7927.0,8641.0
124,"Newton County, Arkansas",3868,185,272,158,166,187,242,147,5,101,05101,428,561,1130,946,479,591,1087,1045,907,1152,2217,1991,7812,3868,3944,7356,2,51,0,33,38082,1958,3753.0,3998.0
125,"Arkansas County, Arkansas",8565,553,611,338,589,581,621,302,5,1,05001,1194,1463,2381,1517,1260,1603,2505,1888,2454,3066,4886,3405,17914,8565,9349,12921,4636,8,89,572,46696,2701,6212.0,6284.0
126,"Lonoke County, Arkansas",35687,2535,2413,1643,2405,2093,2955,1689,5,85,05085,5424,7607,8797,4230,5452,7683,9245,5319,10876,15290,18042,9549,72528,35687,36841,64339,4110,653,967,3241,59094,13805,27100.0,30660.0
127,"Carroll County, Arkansas",13908,823,851,515,758,787,875,557,5,15,05015,1814,2202,3789,2995,1659,2221,3888,3312,3473,4423,7677,6307,27965,13908,14057,25765,289,387,460,4183,46110,5718,10758.0,11639.0
128,"St. Francis County, Arkansas",14094,809,637,517,857,832,644,558,5,123,05123,2182,3518,3421,1900,1635,1942,3065,2273,3817,5460,6486,4173,25900,14094,11806,10630,13845,160,653,1343,35348,3353,7430.0,7054.0
129,"Pulaski County, Arkansas",187895,13429,13811,7402,12863,13737,11058,7282,5,119,05119,32264,37359,46491,25059,32507,40997,52728,33900,64771,78356,99219,58959,392967,187895,205072,219763,144802,8801,7421,24171,51749,76820,159776.0,165468.0
130,"Merced County, California",136987,10980,11871,6891,10331,10593,11712,6595,6,47,06047,26715,26584,28778,13682,24615,25345,28930,16274,51330,51929,57708,29956,271382,136987,134395,149434,8645,20349,78735,161814,53672,28029,70789.0,66575.0
131,"Mariposa County, California",8872,412,452,233,324,364,478,228,6,43,06043,932,1470,2622,2402,895,1202,2669,2388,1827,2672,5291,4790,17420,8872,8548,15402,253,210,415,1963,48820,3438,8877.0,10215.0
132,"Modoc County, California",4626,212,283,191,232,247,213,120,6,49,06049,496,719,1235,1236,446,718,1140,1165,942,1437,2375,2401,8907,4626,4281,7976,136,99,111,1291,45507,1661,3788.0,3805.0
133,"Contra Costa County, California",558502,33495,36175,23934,31954,36275,36721,22856,6,13,06013,84354,111372,152038,77341,81106,115440,160856,98541,165460,226812,312894,175882,1142251,558502,583749,637904,99642,190983,124629,292298,99716,264875,466175.0,498340.0
134,"Inyo County, California",9062,513,484,335,485,626,375,238,6,27,06027,1030,1573,2627,1947,882,1706,2453,2150,1912,3279,5080,4097,17977,9062,8915,14170,153,350,392,4020,57316,3494,8086.0,9147.0
135,"Stanislaus County, California",268871,19998,19923,12746,19378,20684,20341,11985,6,99,06099,47170,53739,61987,30740,45402,52876,64718,38939,92572,106615,126705,69679,543194,268871,274323,415911,16547,30007,49786,251259,60704,78552,172146.0,168279.0
136,"Santa Barbara County, California",222659,14496,14196,8130,13663,13241,13994,7850,6,83,06083,52559,40712,49032,29920,49677,37157,49945,36643,102236,77869,98977,66563,444829,222659,222170,344778,8984,24849,42441,201837,74624,72031,176786.0,154830.0
137,"Tehama County, California",31773,1938,2209,1241,1901,1780,2477,1361,6,103,06103,4635,5545,8066,5788,4227,5255,8619,6519,8862,10800,16685,12307,63912,31773,32139,54795,530,967,3470,15958,44514,10428,23908.0,21525.0
138,"Mono County, California",7634,253,472,360,247,304,321,258,6,51,06051,1324,1726,1963,1080,957,1583,2037,969,2281,3309,4000,2049,14310,7634,6676,11921,111,367,882,3865,62260,3010,5276.0,6511.0
139,"San Benito County, California",30151,1914,1876,1469,1969,2190,2282,1396,6,69,06069,4944,6177,7672,3517,4733,5894,7749,4012,9677,12071,15421,7529,60376,30151,30225,49245,491,1804,5138,36081,86958,9007,21924.0,25290.0
140,"Bryan County, Georgia",18476,1401,1587,1069,1305,1567,1487,795,13,29,13029,2621,4258,4073,1806,2555,4482,4310,2086,5176,8740,8383,3892,37063,18476,18587,28542,5340,529,887,2624,72624,7137,15173.0,21340.0
141,"Butts County, Georgia",12846,702,645,397,629,630,793,415,13,35,13035,2554,2892,3378,1552,1600,1951,3071,2155,4154,4843,6449,3707,24090,12846,11244,16393,6992,101,270,782,43471,3866,9514.0,11786.0
142,"Camden County, Georgia",27495,1891,1780,1138,1929,1850,1676,750,13,39,13039,6914,5029,5771,3169,4627,4697,6614,3593,11541,9726,12385,6762,53231,27495,25736,38864,9997,1170,916,3583,56951,9584,18901.0,23688.0
143,"Crawford County, Georgia",6484,384,404,418,277,264,446,85,13,79,13079,945,1092,1881,1012,736,971,1855,1207,1681,2063,3736,2219,12325,6484,5841,9236,2708,19,201,407,46283,2116,5176.0,6102.0
144,"Early County, Georgia",4793,338,380,216,336,379,347,244,13,99,13099,695,756,1243,808,746,911,1407,1149,1441,1667,2650,1957,10312,4793,5519,4670,5409,57,4,84,30640,1305,4785.0,5184.0
145,"Coffee County, Georgia",22155,1509,1621,1022,1428,1671,1213,790,13,69,13069,4141,4457,5569,2531,3380,3895,5147,3342,7521,8352,10716,5873,43021,22155,20866,29175,12261,338,615,5034,40859,6126,13915.0,15142.0
146,"Coweta County, Georgia",69744,4375,5320,3278,4338,4377,5638,3255,13,77,13077,10242,13387,19477,8706,10291,14557,20419,10641,20533,27944,39896,19347,143260,69744,73516,109508,25618,2980,1666,10040,75913,26620,61745.0,76799.0
147,"Gilmer County, Georgia",15178,707,705,522,896,588,903,620,13,123,13123,1868,2342,4488,3545,1776,2235,4428,3790,3644,4577,8916,7335,30414,15178,15236,27832,166,137,1182,3523,52625,6217,12773.0,16450.0
148,"Walton County, Georgia",44379,2880,3299,2113,2714,2828,3706,2058,13,297,13297,6738,8000,11931,6141,6580,8942,12516,7719,13318,16942,24447,13860,91442,44379,47063,70869,16177,1255,1493,4014,61599,16981,40698.0,50812.0
149,"Wilkes County, Georgia",4771,342,373,264,209,170,366,172,13,317,13317,661,700,1259,962,679,768,1421,1288,1340,1468,2680,2250,9844,4771,5073,5182,4193,38,341,498,37838,1276,4486.0,5029.0
150,"Dodge County, Georgia",10958,679,531,351,386,525,644,342,13,91,13091,1885,2281,2991,1592,1354,1708,2862,2050,3239,3989,5853,3642,20829,10958,9871,14001,5987,69,310,736,39302,4003,7009.0,8064.0
151,"Gordon County, Georgia",28313,1735,1783,1407,1605,1631,2246,1262,13,129,13129,4234,5459,7686,3584,4262,5401,7819,4663,8496,10860,15505,8247,57202,28313,28889,50276,2169,637,2220,9060,45865,8913,18959.0,24033.0
152,"Cherokee County, Georgia",121808,7600,8185,5688,7298,7955,9203,5518,13,57,13057,17143,24474,33757,14841,16987,25490,34838,18418,34130,49964,68595,33259,247515,121808,125707,213668,17274,4472,4931,26044,82740,50799,112043.0,144598.0
153,"Fayette County, Georgia",54446,2703,3495,2906,2376,2977,4479,2958,13,113,13113,7503,8295,16166,9059,7284,9171,17787,10825,14787,17466,33953,19884,112303,54446,57857,75117,25506,5037,2557,8115,90145,27656,60913.0,69110.0
154,"Lee County, Georgia",14736,842,989,761,945,1203,1043,625,13,177,13177,2110,3112,3759,1755,2115,3163,3736,1936,4225,6275,7495,3691,29502,14736,14766,21662,6121,723,164,878,69280,5672,14143.0,16714.0
155,"Pickens County, Georgia",15557,776,863,596,751,787,942,555,13,227,13227,2029,2565,4483,3145,1996,2558,4678,3563,4025,5123,9161,6708,31387,15557,15830,27993,324,134,26,970,67631,5722,14038.0,17116.0
156,"Greene County, Georgia",8535,487,479,332,422,459,425,184,13,133,13133,980,1298,2064,2387,976,1319,2481,2548,1956,2617,4545,4935,17349,8535,8814,10246,6101,198,661,1049,52129,2779,8852.0,11250.0
157,"Cook County, Georgia",8224,615,562,378,510,617,650,401,13,75,13075,1211,1506,2091,1198,1275,1688,2281,1531,2486,3194,4372,2729,17177,8224,8953,11796,4631,124,241,993,41854,2432,6057.0,7035.0
158,"Dawson County, Georgia",12224,652,621,495,663,507,767,458,13,85,13085,1800,2104,3458,2275,1680,2106,3493,2638,3480,4210,6951,4913,24536,12224,12312,23628,258,144,97,1153,66281,5360,11765.0,16075.0
159,"Fulton County, Georgia",501571,31540,32677,19697,30389,32279,31158,19702,13,121,13121,97936,112088,125563,49492,98398,120124,133844,68735,196334,232212,259407,118227,1036200,501571,534629,462133,456855,73129,15345,74764,69673,266850,431391.0,519804.0
160,"Hawaii County, Hawaii",99002,6102,6249,3538,5797,6105,5792,3358,15,1,15001,13107,17605,26538,19563,13123,17926,27647,20709,26230,35531,54185,40272,199459,99002,100457,66493,1266,44971,3799,25386,62409,35982,64867.0,87716.0
161,"Honolulu County, Hawaii",496066,32366,29360,16328,30329,27717,28116,15548,15,3,15003,94878,101112,117340,75223,77348,95477,119074,95146,172226,196589,236414,170369,984821,496066,488755,206218,23603,420093,10332,96985,85857,215288,285790.0,381627.0
162,"Kauai County, Hawaii",35529,2193,2401,1283,2147,2297,1997,1208,15,7,15007,4692,6651,9708,6372,4546,6647,9911,7487,9238,13298,19619,13859,71769,35529,36240,23229,309,23698,437,7933,83554,13393,26335.0,33486.0
163,"Kalawao County, Hawaii",30,1,0,0,0,0,0,0,15,5,15005,2,6,21,0,3,6,16,11,5,12,37,11,66,30,36,16,2,14,0,2,69375,14,,
164,"Cassia County, Idaho",12047,979,1100,688,969,1001,1116,598,16,31,16031,1880,2154,2591,1501,1635,2097,2468,1759,3515,4251,5059,3260,23690,12047,11643,22067,52,139,819,6446,52935,3360,8178.0,9643.0
165,"Lincoln County, Idaho",2805,226,331,136,143,191,235,154,16,63,16063,377,601,615,351,359,549,570,344,736,1150,1185,695,5350,2805,2545,4978,0,22,170,1644,50053,773,1748.0,1940.0
166,"Valley County, Idaho",5411,325,290,174,157,129,379,136,16,85,16085,528,899,1588,1378,466,853,1607,1571,994,1752,3195,2949,10709,5411,5298,10576,6,29,35,495,64475,2360,5349.0,7063.0
167,"Franklin County, Idaho",6915,537,587,424,480,528,648,391,16,41,16041,1004,1210,1452,919,867,1269,1426,940,1871,2479,2878,1859,13464,6915,6549,12748,35,20,287,909,57215,2158,5499.0,6664.0
168,"Nez Perce County, Idaho",19834,1170,1179,732,1198,1201,1110,734,16,69,16069,3171,3706,5066,3594,3121,3536,5197,4286,6292,7242,10263,7880,40217,19834,20383,36037,143,332,148,1579,58107,8069,17201.0,20967.0
169,"Kootenai County, Idaho",77730,4746,5522,3248,4663,5409,4386,3057,16,55,16055,11323,14434,19713,13589,10906,14600,21078,15493,22229,29034,40791,29082,157322,77730,79592,147874,494,1433,810,7270,57242,29749,66310.0,89878.0
170,"Minidoka County, Idaho",10345,768,1005,499,812,982,672,465,16,67,16067,1630,1800,2378,1559,1512,1903,2298,1716,3142,3703,4676,3275,20705,10345,10360,19373,32,55,675,7302,53370,2919,6871.0,7993.0
171,"Twin Falls County, Idaho",41795,3157,3492,1822,3118,3139,3516,1888,16,83,16083,6451,8328,9318,5817,6698,8275,9469,6971,13149,16603,18787,12788,84869,41795,43074,77944,689,1562,2402,13890,52919,13254,29874.0,36680.0
172,"Blaine County, Idaho",11521,595,519,633,570,812,543,308,16,13,16013,1457,2036,3320,1978,1205,1935,3480,1999,2662,3971,6800,3977,22373,11521,10852,21206,98,237,276,5062,56694,5285,10724.0,13343.0
173,"Boise County, Idaho",3779,125,141,156,115,88,225,151,16,15,16015,317,466,1321,994,290,517,1372,841,607,983,2693,1835,7378,3779,3599,7016,19,71,23,338,59646,1631,3814.0,4840.0
174,"Butte County, Idaho",1359,79,123,26,73,110,61,28,16,23,16023,133,228,397,278,137,196,359,258,270,424,756,536,2581,1359,1222,2567,4,0,10,132,42132,468,1230.0,1415.0
175,"Gooding County, Idaho",7773,517,663,378,515,704,462,368,16,47,16047,1131,1372,1902,1253,966,1188,1897,1275,2097,2560,3799,2528,15148,7773,7375,14091,13,139,417,4403,47204,2336,5191.0,6050.0
176,"Ada County, Idaho",228886,13657,15219,10191,13066,14544,16526,9542,16,1,16001,37361,49392,56875,29139,34701,47570,57419,34595,72062,96962,114294,63734,456849,228886,227963,413350,6274,11617,6965,37469,66293,94404,195669.0,259389.0
177,"Bear Lake County, Idaho",2958,209,261,144,202,266,192,145,16,7,16007,401,471,714,593,365,538,692,642,766,1009,1406,1235,6000,2958,3042,5659,53,40,114,257,54167,1075,2928.0,3215.0
178,"Bingham County, Idaho",22914,1718,2140,1158,1772,2150,1886,1223,16,11,16011,3374,4061,5298,2997,3222,4226,5148,3298,6596,8287,10446,6295,45839,22914,22925,37701,143,263,3197,8247,55472,6786,16625.0,20094.0
179,"Camas County, Idaho",497,47,33,17,27,62,43,17,16,25,16025,61,63,164,87,46,88,158,110,107,151,322,197,1048,497,551,1045,0,0,0,17,39688,232,590.0,754.0
180,"Clearwater County, Idaho",4831,176,172,181,135,187,152,134,16,35,16035,665,787,1388,1204,357,540,1228,1109,1022,1327,2616,2313,8673,4831,3842,8040,46,35,121,367,43915,1913,3801.0,4419.0
181,"Jefferson County, Idaho",14526,1299,1313,804,1130,1324,1479,807,16,51,16051,2178,2778,3173,1500,1892,2740,3009,1627,4070,5518,6182,3127,28534,14526,14008,26039,0,127,1532,3004,63048,4169,11475.0,14171.0
182,"Lane County, Oregon",183845,9579,9734,6272,8844,9198,9663,6001,41,39,41039,37223,33943,44817,32135,36085,33410,48246,38048,73308,67353,93063,70183,373340,183845,189495,323102,4064,10127,10908,33109,52426,72454,191950.0,218521.0
183,"Surry County, Virginia",3154,136,165,62,150,129,163,157,51,181,51181,426,449,1088,659,408,477,1131,754,834,926,2219,1413,6523,3154,3369,3454,2897,11,11,41,57962,1269,4228.0,4462.0
184,"Clarke County, Virginia",7321,341,583,360,297,263,457,304,51,43,51043,990,1000,2303,1369,729,1150,2281,1621,1719,2150,4584,2990,14423,7321,7102,12951,777,102,212,803,80026,3418,8213.0,9290.0
185,"Mecklenburg County, Virginia",14889,750,720,515,807,621,947,506,51,117,51117,1957,2310,4271,3420,1845,2220,4591,4302,3802,4530,8862,7722,30728,14889,15839,19193,10891,29,107,911,43207,5040,14945.0,16182.0
186,"Augusta County, Virginia",38267,1698,1755,1458,1710,1756,2262,1284,51,15,51015,5551,7018,11113,7227,4471,6080,11108,8141,10022,13098,22221,15368,75079,38267,36812,69533,3195,460,250,2118,62711,17573,36343.0,41898.0
187,"Goochland County, Virginia",11347,487,493,435,354,503,629,462,51,75,51075,1463,1809,3605,2358,1290,1752,3944,2584,2753,3561,7549,4942,22865,11347,11518,18355,3655,297,89,651,93994,5512,14037.0,16759.0
188,"Madison County, Virginia",6403,273,465,249,352,335,491,212,51,113,51113,716,1242,1798,1325,810,1024,2019,1524,1526,2266,3817,2849,13170,6403,6767,11259,1087,111,225,381,57895,2668,6979.0,8108.0
189,"Roanoke County, Virginia",45121,2296,2520,1933,2122,2637,2667,1718,51,161,51161,6208,8252,12236,8593,6287,8336,13685,11250,12495,16588,25921,19843,93823,45121,48702,82563,5571,2913,581,2907,68948,20951,51489.0,55845.0
190,"Brunswick County, Virginia",8843,337,264,279,372,356,388,237,51,25,51025,1758,1923,2187,1571,951,1164,2328,1881,2709,3087,4515,3452,16520,8843,7677,6931,8996,85,144,370,44434,2126,7669.0,7915.0
191,"Northampton County, Virginia",5718,331,257,195,298,286,377,146,51,131,51131,748,824,1511,1378,643,872,1830,1715,1391,1696,3341,3093,11885,5718,6167,7371,3953,123,95,1043,47227,2084,6172.0,6722.0
192,"Rockbridge County, Virginia",11227,538,632,339,442,596,438,461,51,163,51163,1394,1827,3214,2733,1300,1769,3316,3021,2694,3596,6530,5754,22570,11227,11343,21067,737,149,95,430,54600,5076,10795.0,12368.0
193,"Norton city, Virginia",1852,201,58,71,155,162,67,44,51,720,51720,281,379,406,273,309,399,604,378,590,778,1010,651,3970,1852,2118,3565,122,184,0,48,29000,675,1460.0,1597.0
194,"Colonial Heights city, Virginia",8060,609,504,286,456,546,634,336,51,570,51570,1201,1473,1967,1414,1323,1597,2340,2136,2524,3070,4307,3550,17428,8060,9368,13163,2673,724,265,1023,54550,3104,8457.0,9114.0
195,"Bland County, Virginia",3564,215,146,113,60,179,111,79,51,21,51021,504,753,986,716,321,449,903,722,825,1202,1889,1438,6388,3564,2824,6066,243,10,6,81,48531,1593,3139.0,3475.0
196,"Botetourt County, Virginia",16365,730,694,672,689,896,979,716,51,23,51023,1936,2529,5255,3434,1995,2510,5325,3868,3931,5039,10580,7302,33343,16365,16978,31393,994,223,89,568,71110,7685,18739.0,20924.0
197,"Bristol city, Virginia",7961,427,525,446,509,479,497,357,51,520,51520,1083,1534,2203,1379,1217,1554,2261,2077,2300,3088,4464,3456,16912,7961,8951,15299,964,38,73,391,37500,3497,7032.0,7802.0
198,"Williamsburg city, Virginia",6929,356,256,176,159,219,122,109,51,830,51830,2968,761,1203,1050,3842,994,1261,1292,6810,1755,2464,2342,14927,6929,7998,10961,2246,963,169,1053,57463,2802,7626.0,6845.0
199,"Carroll County, Virginia",15004,878,670,596,617,703,776,477,51,35,51035,1969,2295,4405,3282,1612,2375,4428,3809,3581,4670,8833,7091,29801,15004,14797,29012,213,17,49,1053,44835,5789,13668.0,15619.0
200,"Sacramento County, California",744997,50401,51384,30639,48675,50616,49223,29509,6,67,06067,129001,157765,182431,90647,126314,159693,196577,118949,255315,317458,379008,209596,1524553,744997,779556,873905,149891,239447,119922,353318,67151,289509,559330.0,448524.0
201,"El Dorado County, California",93922,4431,5264,3773,4239,4929,5795,3503,6,17,06017,12156,15233,28528,18549,10818,15576,29760,20021,22974,30809,58288,38570,188563,93922,94641,165234,1516,8540,3992,24199,83377,38804,93591.0,113446.0
202,"Monterey County, California",221001,16080,16388,9083,15423,15295,16097,8880,6,53,06053,39276,46870,50560,26121,35949,40800,48846,31119,75225,87670,99406,57240,433410,221001,212409,230992,11367,24326,143041,254294,71015,58296,133408.0,131444.0
203,"San Francisco County, California",446286,20174,15900,8578,19362,15439,14497,8251,6,75,06075,83234,126977,115258,60820,81962,113399,101604,74161,165196,240376,216862,134981,874961,446286,428675,406056,45556,301018,67207,133314,112449,281712,405792.0,378512.0
204,"San Diego County, California",1669515,107496,98573,60115,102184,97185,96433,57270,6,73,06073,341149,360013,396602,202085,290753,341988,408741,252004,631902,702001,805343,454089,3316073,1669515,1646558,2345667,166750,394742,198729,1117517,78980,698218,1306400.0,1405839.0
205,"Tulare County, California",230966,19369,21062,11971,18422,20214,19793,11517,6,107,06107,41354,45245,47811,23344,39708,44310,48781,28187,81062,89555,96592,51531,461898,230966,230932,340462,7201,16690,74949,298245,49687,53101,112334.0,124214.0
206,"Humboldt County, California",67576,3684,3631,2107,3551,3796,3435,2156,6,23,06023,13480,13589,16475,10833,13489,12372,16880,12685,26969,25961,33355,23518,135940,67576,68364,108557,1506,4196,5707,15722,48041,25598,59246.0,46222.0
207,"Alpine County, California",554,22,21,9,22,29,20,25,6,3,06003,49,93,137,170,40,100,108,141,89,193,245,311,1039,554,485,599,9,10,9,130,63750,202,602.0,736.0
208,"Madera County, California",74972,5912,6023,3533,5699,6283,5803,3341,6,39,06039,12753,13694,16595,10203,13451,16036,18620,11228,26204,29730,35215,21431,155433,74972,80461,108100,4949,3229,31429,89798,57585,17865,43112.0,51405.0
209,"Santa Cruz County, California",135634,7203,7407,4723,6989,6961,7601,4470,6,87,06087,29529,24013,35055,19937,28945,23898,36246,23218,58474,47911,71301,43155,273962,135634,138328,204866,2904,13134,38130,91980,82234,54774,128821.0,138638.0
210,"Trinity County, California",6535,334,278,239,252,375,210,173,6,105,06105,712,850,2050,1767,470,1089,1953,1643,1182,1939,4003,3410,12700,6535,6165,10924,127,226,428,927,40846,2641,5686.0,5095.0
211,"Riverside County, California",1200960,80545,85529,54914,77054,82544,87828,53419,6,65,06065,210173,235755,286337,155391,200308,234383,289759,185184,410481,470138,576096,340575,2411439,1200960,1210479,1444654,156836,157261,519122,1179478,67005,356294,751391.0,513358.0
212,"San Bernardino County, California",1069766,78467,80167,50052,75317,78117,78371,47520,6,71,06071,206348,215493,247024,108658,192500,214139,259998,133303,398848,429632,507022,241961,2149031,1069766,1079265,1315238,179292,154332,368600,1145874,63362,319832,653983.0,574585.0
213,"Marin County, California",126956,5999,7011,4974,6165,7265,7852,4691,6,41,06041,14444,21911,38961,24980,12973,21116,41735,31190,27417,43027,80696,56170,259943,126956,132987,202313,5767,15367,22258,41527,115246,72291,139273.0,135667.0
214,"Placer County, California",188162,10507,12556,8122,10013,12136,12398,7753,6,61,06061,25306,35399,50460,32966,23845,36230,54169,40806,49151,71629,104629,73772,385512,188162,197350,316716,6626,28909,11358,53969,89691,83073,182839.0,185153.0
215,"Shasta County, California",88047,5423,5689,3500,5121,5228,5324,3188,6,89,06089,13290,15308,22952,16679,12419,15422,24870,19593,25709,30730,47822,36272,179212,88047,91165,155124,2088,5798,3607,17975,54667,31482,80053.0,88761.0
216,"Solano County, California",219818,13822,13740,8378,12976,13454,13511,8287,6,95,06095,38253,44049,57030,29875,34187,42610,59552,37434,72440,86659,116582,67309,441829,219818,222011,232437,61526,68200,40346,116869,81472,80898,166113.0,194829.0
217,"Colusa County, California",10994,742,919,521,834,726,826,457,6,11,06011,1822,2046,2626,1501,1574,1940,2522,1581,3396,3986,5148,3082,21454,10994,10460,18949,327,309,997,12738,59401,2832,6632.0,7672.0
218,"Copiah County, Mississippi",13601,810,1040,574,936,901,909,579,28,29,28029,2439,2314,3475,2085,2325,2561,3980,2709,4764,4875,7455,4794,28501,13601,14900,12849,14698,108,449,902,42151,3505,12982.0,10800.0
219,"Hinds County, Mississippi",111362,7822,7936,4984,7762,7875,8243,5000,28,49,28049,21534,20637,26177,13437,23842,24073,31520,19120,45376,44710,57697,32557,238797,111362,127435,60513,173413,1851,1277,3676,44625,38654,94681.0,81811.0
220,"Union County, Mississippi",14012,936,1220,617,889,1016,1021,595,28,145,28145,2163,2709,3426,2077,2134,2632,3606,2602,4297,5341,7032,4679,28507,14012,14495,22559,4424,102,936,1248,45754,4079,11496.0,10989.0
221,"Tippah County, Mississippi",10641,714,708,464,666,563,950,509,28,139,28139,1801,1720,2984,1444,1785,2055,2844,2005,3586,3775,5828,3449,22018,10641,11377,17041,3686,63,830,1051,39246,3423,9235.0,10001.0
222,"Forrest County, Mississippi",35722,2587,2391,1424,2431,2382,2342,1306,28,35,28035,7835,6846,7879,4177,9469,7009,8744,5819,17304,13855,16623,9996,75224,35722,39502,44649,27951,639,198,2203,39840,11916,28064.0,26540.0
223,"Lafayette County, Mississippi",25822,1364,1545,706,1485,1374,1327,908,28,71,28071,8158,4914,5103,2864,8349,5153,5531,3641,16507,10067,10634,6505,53590,25822,27768,38275,12657,1116,798,1407,50272,10069,19643.0,17163.0
224,"Lowndes County, Mississippi",28141,2030,1990,1188,1854,1945,1786,1152,28,87,28087,4964,5122,6954,3829,5192,5596,8157,5327,10156,10718,15111,9156,59150,28141,31009,31595,25902,602,166,1204,50441,9538,25575.0,26993.0
225,"Wilkinson County, Mississippi",4870,301,357,198,206,222,227,161,28,157,28157,926,1101,1113,648,514,628,1198,849,1440,1729,2311,1497,8875,4870,4005,2475,6307,10,21,19,27313,1124,4218.0,3606.0
226,"Jefferson Davis County, Mississippi",5421,255,316,193,266,324,306,186,28,65,28065,823,903,1431,1062,835,970,1616,1415,1658,1873,3047,2477,11339,5421,5918,4303,6950,14,12,40,32116,1574,6237.0,4650.0
227,"Scott County, Mississippi",14052,974,1214,691,915,921,1022,527,28,123,28123,2146,2669,3280,1811,2101,2802,3586,2406,4247,5471,6866,4217,28332,14052,14280,16211,10791,73,935,3197,34943,3552,10522.0,9386.0
228,"Yazoo County, Mississippi",16638,963,1033,643,686,852,905,406,28,163,28163,3074,4933,3603,1513,1872,2068,3012,2126,4946,7001,6615,3639,28565,16638,11927,10533,17027,126,444,1312,33279,3446,10070.0,9012.0
229,"Bolivar County, Mississippi",15012,1134,1141,763,1050,1111,1094,522,28,11,28011,2722,2736,3484,1931,2896,3082,4232,2849,5618,5818,7716,4780,31848,15012,16836,10497,20453,286,424,687,29854,4215,13824.0,11631.0
230,"Pike County, Mississippi",18741,1394,1563,910,1301,1846,1115,852,28,113,28113,3044,3084,4553,2774,3092,3591,5197,3797,6136,6675,9750,6571,39532,18741,20791,17315,21456,125,169,628,31784,4897,16310.0,14640.0
231,"Stone County, Mississippi",9199,488,667,337,488,546,563,306,28,131,28131,1592,1624,2449,1471,1701,1709,2302,1462,3293,3333,4751,2933,18276,9199,9077,14300,3351,0,0,369,45483,2979,7045.0,6546.0
232,"Kemper County, Mississippi",5059,281,219,278,138,198,311,148,28,69,28069,1037,908,1176,852,931,715,1370,1073,1968,1623,2546,1925,9943,5059,4884,3433,6134,7,0,58,31103,1144,4639.0,3935.0
233,"Sunflower County, Mississippi",13867,829,866,497,730,743,1029,495,28,133,28133,3011,3120,3353,1397,2059,2097,3161,1987,5070,5217,6514,3384,26168,13867,12301,6595,19332,20,103,474,30838,3030,9598.0,7568.0
234,"Adams County, Mississippi",16132,953,712,617,952,902,833,482,28,1,28001,2456,3576,4373,2408,2036,2401,4220,3308,4492,5977,8593,5716,31266,16132,15134,12796,17610,187,240,1829,29936,5030,13836.0,12268.0
235,"DeSoto County, Mississippi",86292,5538,6470,4416,5433,5925,7101,4334,28,33,28033,13768,17082,22036,9822,13432,19881,23768,12809,27200,36963,45804,22631,178975,86292,92683,119455,48835,2524,3817,8836,67038,31632,65695.0,75013.0
236,"Delaware County, Pennsylvania",271636,17307,17847,11609,16427,16218,17765,10479,42,45,42045,46357,50484,72702,38085,46586,53526,79600,52317,92943,104010,152302,90402,564554,271636,292918,388106,121802,32094,6515,21472,74477,133140,297634.0,321088.0
237,"Somerset County, Pennsylvania",38821,1815,1734,1358,1640,1911,1808,1251,42,111,42111,5440,7305,11715,7356,4099,5608,10401,8822,9539,12913,22116,16178,74361,38821,35540,70757,1913,251,295,1115,49089,18898,35773.0,40093.0
238,"Madison County, Missouri",5948,342,389,283,324,367,375,269,29,123,29123,842,1012,1594,1052,855,1046,1761,1234,1697,2058,3355,2286,12179,5948,6231,11798,92,69,16,288,43636,2451,5321.0,5671.0
239,"Vernon County, Missouri",10066,679,794,468,600,654,601,489,29,217,29217,1408,1629,2630,1749,1611,1683,2781,2110,3019,3312,5411,3859,20595,10066,10529,19685,111,148,27,445,43276,4714,8599.0,9164.0
240,"Nodaway County, Missouri",11102,521,468,317,504,460,476,326,29,147,29147,3807,1756,2258,1476,3856,1524,2271,1840,7663,3280,4529,3316,22359,11102,11257,20946,617,306,88,386,44232,4642,9458.0,9874.0
241,"Chariton County, Missouri",3722,255,202,172,233,214,218,143,29,41,29041,453,540,1019,811,419,570,998,966,872,1110,2017,1777,7483,3722,3761,7142,191,0,0,40,46738,1963,3969.0,4074.0
242,"Wayne County, Missouri",6442,330,264,283,336,409,478,251,29,223,29223,784,974,1877,1450,707,946,2027,1599,1491,1920,3904,3049,13195,6442,6753,12747,73,36,0,238,34316,2271,5655.0,5874.0
243,"Scott County, Missouri",18685,1298,1582,748,1188,1320,1211,725,29,201,29201,2760,3241,4917,2998,2802,3455,5360,3887,5562,6696,10277,6885,38633,18685,19948,32934,4494,160,198,893,44139,7559,17256.0,17748.0
244,"Barton County, Missouri",5818,323,332,351,337,390,363,261,29,11,29011,754,1004,1561,1041,753,959,1585,1331,1507,1963,3146,2372,11797,5818,5979,10959,35,4,23,187,44125,2517,5939.0,6077.0
245,"Cedar County, Missouri",7041,490,392,325,434,517,374,285,29,39,29039,852,1020,1846,1543,804,1022,1833,1733,1656,2042,3679,3276,14043,7041,7002,13507,7,30,69,317,39365,2753,6288.0,7039.0
246,"Gasconade County, Missouri",7388,421,411,289,324,344,466,262,29,73,29073,889,1108,2261,1483,899,1137,2089,1802,1788,2245,4350,3285,14711,7388,7323,14300,79,50,24,210,54885,3254,7445.0,7934.0
247,"Macon County, Missouri",7633,511,540,333,383,577,467,261,29,121,29121,1001,1225,1994,1494,848,1166,2015,1849,1849,2391,4009,3343,15199,7633,7566,14346,297,94,33,228,42746,3514,7621.0,7834.0
248,"Oregon County, Missouri",5268,334,267,211,297,407,271,202,29,149,29149,656,780,1463,1125,582,777,1503,1340,1238,1557,2966,2465,10647,5268,5379,10157,16,51,43,195,33601,2237,4668.0,4742.0
249,"Ste. Genevieve County, Missouri",9050,452,501,365,437,578,483,406,29,186,29186,1167,1545,2737,1622,1084,1447,2600,1763,2251,2992,5337,3385,17848,9050,8798,17257,350,102,27,211,60129,4351,8469.0,9495.0
250,"Douglas County, Missouri",6648,391,486,247,361,360,440,238,29,67,29067,760,1003,1874,1517,700,986,1909,1664,1460,1989,3783,3181,13306,6648,6658,13079,30,11,80,115,37425,2703,6666.0,6994.0
251,"Henry County, Missouri",10708,612,648,396,639,615,720,430,29,83,29083,1361,1777,3031,2139,1263,1884,2969,2507,2624,3661,6000,4646,21735,10708,11027,20743,273,107,55,535,45795,4777,9866.0,10776.0
252,"Lawrence County, Missouri",18918,1265,1418,839,1306,1245,1403,885,29,109,29109,2659,3352,4927,3128,2427,3254,5076,3690,5086,6606,10003,6818,38204,18918,19286,36225,184,14,629,2847,44742,7728,16715.0,17930.0
253,"Pulaski County, Missouri",29924,1829,1853,859,1613,1246,1669,819,29,169,29169,11532,5752,4513,1952,5355,4722,4654,2423,16887,10474,9167,4375,52425,29924,22501,39671,5879,1316,1550,5879,53492,8573,13488.0,14419.0
254,"Texas County, Missouri",13364,732,867,505,668,895,624,472,29,215,29215,1730,2547,3737,2474,1405,1954,3447,2775,3135,4501,7184,5249,25604,13364,12240,23769,559,190,77,544,35067,5019,10956.0,11332.0
255,"Callaway County, Missouri",22886,1269,1216,819,1195,1368,1242,912,29,27,29027,4025,4596,6152,3316,3565,3826,6099,3796,7590,8422,12251,7112,44889,22886,22003,41309,1969,366,26,940,56938,9436,19193.0,21178.0
256,"Cooper County, Missouri",9280,524,533,317,453,500,582,332,29,53,29053,1801,1819,2346,1349,1136,1454,2235,1688,2937,3273,4581,3037,17660,9280,8380,15675,1029,80,112,352,52735,3797,7986.0,8710.0
257,"Gentry County, Missouri",3199,222,233,127,243,244,236,129,29,75,29075,432,524,885,571,460,535,844,726,892,1059,1729,1297,6616,3199,3417,6442,39,36,13,107,47790,1572,3043.0,3239.0
258,"Washington County, Virginia",26584,1173,1336,919,1043,1315,1470,1075,51,191,51191,3677,4662,7777,5465,3387,4472,8186,6539,7064,9134,15963,12004,54071,26584,27487,51972,750,305,208,821,48495,12089,25847.0,28684.0
259,"Page County, Virginia",11754,564,587,434,588,551,799,458,51,139,51139,1490,2040,3497,2296,1419,2000,3549,2670,2909,4040,7046,4966,23788,11754,12034,22671,327,103,156,479,51792,5438,10740.0,12432.0
260,"Alexandria city, Virginia",75954,5838,3934,1750,5376,3523,3266,1787,51,510,51510,11332,23826,18484,7632,13425,24199,19949,10134,24757,48025,38433,17766,157613,75954,81659,98017,34287,9280,7233,26309,100939,50868,75770.0,80425.0
261,"Hampton city, Virginia",65105,4226,3550,2497,4053,3222,4464,2125,51,650,51650,14188,11849,15915,8505,13264,13018,18080,11710,27452,24867,33995,20215,135041,65105,69936,55513,67450,3352,2198,7783,56287,25093,62356.0,64654.0
262,"Arlington County, Virginia",116785,7159,6090,2767,6715,5620,5241,2762,51,13,51013,24415,33388,26733,11020,24723,32523,25650,13445,49138,65911,52383,24465,233464,116785,116679,166912,21360,23959,11215,36375,120071,81014,121356.0,129202.0
263,"Buchanan County, Virginia",10958,449,662,393,415,461,669,351,51,27,51027,1537,1909,3378,2100,1256,1746,3363,2569,2793,3655,6741,4669,21788,10958,10830,20678,592,225,107,106,31956,4293,9247.0,9953.0
264,"Stafford County, Virginia",74067,4792,5445,3581,4571,5131,5564,3572,51,179,51179,13045,15172,19515,6778,10962,15108,19719,8079,24007,30280,39234,14857,146773,74067,72706,98791,25929,4910,8601,19008,111108,30950,65934.0,79021.0
265,"Richmond city, Virginia",107430,6836,5397,2680,6516,5746,4807,2751,51,760,51760,26030,24118,25097,12049,29628,24342,28366,17036,55658,48460,53463,29085,226622,107430,119192,103054,106193,4757,3902,15661,47250,44547,103484.0,103917.0
266,"Essex County, Virginia",4970,286,276,179,354,236,481,155,51,57,51057,650,774,1468,1079,779,951,1708,1364,1429,1725,3176,2443,10998,4970,6028,6115,4319,68,313,396,51954,1756,5408.0,6171.0
267,"Tazewell County, Virginia",20647,1059,1190,795,1135,1237,900,662,51,185,51185,2856,3843,5943,3909,2513,3430,6050,5029,5369,7273,11993,8938,41603,20647,20956,39273,1336,255,123,424,42099,8160,18566.0,19989.0
268,"Manassas Park city, Virginia",8887,707,532,467,391,734,659,217,51,685,51685,1451,2247,2135,707,1416,2066,1886,730,2867,4313,4021,1437,16986,8887,8099,10576,2607,1884,1230,6749,88046,3214,5232.0,6071.0
269,"Sussex County, Virginia",6811,268,228,176,219,211,267,142,51,183,51183,1574,1657,1750,880,586,664,1388,1089,2160,2321,3138,1969,11377,6811,4566,4535,6288,146,87,344,49487,1663,5044.0,5081.0
270,"Manassas city, Virginia",20657,1711,1612,920,1733,1453,1471,691,51,683,51683,3450,4762,4977,1757,3407,4338,5178,2246,6857,9100,10155,4003,41174,20657,20517,27233,5599,2143,3661,15086,81493,7279,15411.0,16555.0
271,"Salem city, Virginia",11771,550,662,462,585,1005,561,448,51,775,51775,2352,2068,3098,2008,2525,2026,3601,2795,4877,4094,6699,4803,25317,11771,13546,22115,1706,438,237,834,57165,4685,12225.0,13051.0
272,"Charlotte County, Virginia",5926,316,290,328,282,361,415,221,51,37,51037,816,842,1687,1189,720,890,1780,1445,1536,1732,3467,2634,12040,5926,6114,8415,3371,48,17,260,40573,1801,5808.0,6191.0
273,"Greensville County, Virginia",7256,263,220,88,186,288,251,181,51,81,51081,1414,1907,2263,772,525,675,1225,938,1939,2582,3488,1710,11525,7256,4269,4350,6844,7,44,292,50300,1586,4363.0,4565.0
274,"Thurston County, Washington",136855,8453,8746,5258,7860,8562,7900,4939,53,67,53067,21994,28442,34317,21008,21159,28968,37546,25922,43153,57410,71863,46930,279711,136855,142856,227952,8826,15832,4056,25004,72003,57953,129410.0,152918.0
275,"Columbia County, Washington",1926,73,104,66,101,126,110,53,53,13,53013,163,321,518,534,173,335,574,594,336,656,1092,1128,3992,1926,2066,3568,36,72,55,311,53423,742,2182.0,2397.0
276,"Guayanilla Municipio, Puerto Rico",8817,408,488,391,447,499,642,361,72,59,72059,1404,1635,2195,1666,1473,1734,2505,2036,2877,3369,4700,3702,18514,8817,9697,14531,399,134,3312,18403,17379,4065,,
277,"Sabana Grande Municipio, Puerto Rico",10614,510,552,447,490,574,675,415,72,121,72121,1743,1857,2552,2169,1805,2057,3107,2823,3548,3914,5659,4992,22560,10614,11946,15875,474,0,5771,22487,17319,4362,,
278,"Hormigueros Municipio, Puerto Rico",7340,272,318,311,262,428,362,297,72,67,72067,1101,1261,1794,1809,1086,1407,2268,2493,2187,2668,4062,4302,15943,7340,8603,4095,379,0,11201,15916,19030,2944,,
279,"Utuado Municipio, Puerto Rico",13910,637,645,574,598,853,800,554,72,141,72141,2226,2237,3806,2774,2206,2521,4032,3202,4432,4758,7838,5976,28676,13910,14766,15154,296,49,12613,28458,15399,4655,,
280,"Florida Municipio, Puerto Rico",5624,329,227,276,245,339,348,206,72,54,72054,1005,1101,1282,933,1041,1145,1626,1123,2046,2246,2908,2056,11697,5624,6073,9778,183,99,1441,11564,20442,1718,,
281,"Moca Municipio, Puerto Rico",17635,820,838,767,807,1019,1086,763,72,99,72099,2971,3337,4604,2910,3055,3557,5052,3187,6026,6894,9656,6097,36161,17635,18526,29787,1159,29,4848,35896,15037,6487,,
282,"Salinas Municipio, Puerto Rico",13584,679,997,719,640,698,1004,609,72,123,72123,2308,2413,3313,2328,2233,2710,3699,2932,4541,5123,7012,5260,28109,13584,14525,16127,10807,52,913,28038,18189,4594,,
283,"Mississippi County, Missouri",7427,348,341,256,276,508,282,212,29,133,29133,1214,1608,1977,1048,833,1069,1627,1340,2047,2677,3604,2388,13574,7427,6147,9913,3377,9,15,296,35357,2332,5169.0,4756.0
284,"Ozark County, Missouri",4489,204,336,152,191,300,245,221,29,153,29153,443,593,1321,1261,427,640,1434,1260,870,1233,2755,2521,9207,4489,4718,8838,6,47,9,166,31947,2046,4505.0,4870.0
285,"Bollinger County, Missouri",6068,349,334,242,287,428,335,253,29,17,29017,741,1032,1801,1134,747,1022,1823,1262,1488,2054,3624,2396,12225,6068,6157,11872,50,44,0,137,44158,2751,5676.0,5981.0
286,"Sumner County, Tennessee",89689,5759,6294,3930,5395,6292,5788,3772,47,165,47165,12953,17371,24365,12691,12405,18623,25623,15850,25358,35994,49988,28541,183437,89689,93748,159883,13457,2564,2818,8949,67204,38013,71505.0,92529.0
287,"Trousdale County, Tennessee",5987,418,266,206,177,312,208,95,47,169,47169,1569,1477,1206,597,600,822,1202,828,2169,2299,2408,1425,10231,5987,4244,8690,1042,25,30,110,56321,2013,3160.0,3991.0
288,"Clay County, Tennessee",3669,157,289,88,215,234,207,192,47,27,47027,441,589,1084,853,451,574,1148,964,892,1163,2232,1817,7654,3669,3985,7258,183,8,137,200,32167,1717,2920.0,3506.0
289,"Moultrie County, Illinois",7199,471,545,362,487,518,470,303,17,139,17139,985,1248,1849,1219,937,1303,1877,1547,1922,2551,3726,2766,14641,7199,7442,14310,112,23,40,212,61456,2778,6283.0,6698.0
290,"Pike County, Illinois",7744,512,531,301,456,536,476,281,17,149,17149,1088,1331,2101,1430,1030,1254,2100,1795,2118,2585,4201,3225,15672,7744,7928,15185,191,57,37,202,47492,3473,7530.0,7836.0
291,"Pope County, Illinois",2262,84,103,23,70,85,86,41,17,151,17151,278,298,770,572,148,264,669,578,426,562,1439,1150,4203,2262,1941,3893,177,24,46,116,38056,852,2142.0,2172.0
292,"St. Clair County, Illinois",126734,8589,9102,5427,8047,8140,8703,5123,17,163,17163,19992,24079,33768,17069,19705,26028,36966,22892,39697,50107,70734,39961,262338,126734,135604,168096,78532,3861,3402,10748,55179,46070,120580.0,125220.0
293,"Shelby County, Illinois",10721,594,683,409,570,582,641,479,17,173,17173,1367,1807,2990,2195,1313,1721,3104,2606,2680,3528,6094,4801,21737,10721,11016,21357,149,63,3,229,52953,4999,11010.0,12049.0
294,"Champaign County, Illinois",104627,5921,5652,3395,5610,5173,5404,3251,17,19,17019,34099,18463,20480,11438,30885,18310,22141,14521,64984,36773,42621,25959,209922,104627,105295,150820,28283,22579,2137,12518,52797,45702,91628.0,93019.0
295,"Calhoun County, Illinois",2420,117,73,87,127,96,184,89,17,13,17013,289,372,729,517,261,358,688,607,550,730,1417,1124,4830,2420,2410,4719,15,43,1,61,63009,1154,2571.0,2767.0
296,"Ford County, Illinois",6551,406,480,299,314,444,376,320,17,53,17053,921,1118,1894,1055,803,1139,1880,1443,1724,2257,3774,2498,13270,6551,6719,12610,150,87,263,443,52092,2553,6396.0,6809.0
297,"Kane County, Illinois",264564,17541,18603,13127,16537,18008,20319,12276,17,89,17089,40285,52496,69938,31285,38543,51682,70782,38665,78828,104178,140720,69950,531376,264564,266812,387883,29416,21612,74326,169364,79394,93671,199314.0,231734.0
298,"Kendall County, Illinois",62117,4399,5521,2983,4292,5423,5014,3270,17,93,17093,8730,14333,15099,5608,8534,15088,15171,7145,17264,29421,30270,12753,126054,62117,63937,102605,9339,4045,6532,23571,96563,25026,53447.0,61327.0
299,"Brown County, Illinois",4193,162,237,61,134,72,233,91,17,9,17009,913,1087,1132,449,300,472,622,511,1213,1559,1754,960,6628,4193,2435,5265,1272,0,44,440,61655,1222,2379.0,2523.0
300,"Marion County, Illinois",18613,1294,1345,678,1129,1232,1078,747,17,121,17121,2663,3255,4926,3280,2616,3124,5196,4008,5279,6379,10122,7288,37743,18613,19130,34902,1382,243,175,765,47519,6857,17074.0,17214.0
301,"Mason County, Illinois",6708,344,399,253,357,315,459,272,17,125,17125,849,1125,1956,1364,821,1150,1898,1641,1670,2275,3854,3005,13621,6708,6913,13214,103,24,46,153,48417,2950,6486.0,6756.0
302,"Iroquois County, Illinois",13576,719,778,592,769,831,897,569,17,75,17075,1841,2259,3829,2641,1618,2316,3982,3254,3459,4575,7811,5895,27812,13576,14236,25746,240,98,1190,1941,52700,5759,13064.0,14011.0
303,"Clay County, Illinois",6634,400,429,300,344,404,423,276,17,25,17025,873,1121,1893,1177,842,1103,1777,1484,1715,2224,3670,2661,13287,6634,6653,12782,107,42,1,17,48500,2535,6350.0,6896.0
304,"Gallatin County, Illinois",2463,134,115,85,121,132,192,93,17,59,17059,300,448,686,529,286,439,676,662,586,887,1362,1191,5064,2463,2601,4888,26,6,14,66,44076,1034,2707.0,2673.0
305,"Monroe County, Illinois",16788,975,1070,740,888,931,1252,676,17,133,17133,2106,3216,4922,2649,2013,3225,5153,3242,4119,6441,10075,5891,34168,16788,17380,33251,60,444,168,525,85747,7732,19354.0,21024.0
306,"Union County, Illinois",8508,477,459,321,458,437,544,285,17,181,17181,1145,1465,2431,1602,1053,1469,2346,1868,2198,2934,4777,3470,16968,8508,8460,15963,276,56,239,880,50625,3691,8537.0,8896.0
307,"Winnebago County, Illinois",139039,9172,9216,6017,8765,8902,9315,5812,17,201,17201,20963,25030,37320,21430,21036,26018,38910,27022,41999,51048,76230,48452,284819,139039,145780,224363,36935,7530,5656,36371,54489,51393,118376.0,121684.0
308,"Pulaski County, Illinois",2717,112,142,151,168,114,216,63,17,153,17153,364,418,744,546,353,441,783,655,717,859,1527,1201,5510,2717,2793,3620,1669,7,10,128,34640,881,2735.0,2631.0
309,"Schuyler County, Illinois",3641,149,139,121,141,146,247,133,17,169,17169,449,705,1125,725,369,531,942,803,818,1236,2067,1528,6953,3641,3312,6219,625,0,0,67,52357,1566,3828.0,3908.0
310,"Edgar County, Illinois",8540,471,398,329,424,465,513,328,17,45,17045,1087,1513,2484,1657,1071,1475,2471,2120,2158,2988,4955,3777,17407,8540,8867,17212,53,31,35,210,53647,3388,7873.0,8152.0
311,"Boone County, Illinois",26792,1579,1674,1464,1475,1533,2187,1280,17,7,17007,4035,4762,7234,3722,3820,4773,7065,4612,7855,9535,14299,8334,53537,26792,26745,46852,1184,632,3395,11673,69272,10310,23001.0,24672.0
312,"Bureau County, Illinois",16334,873,906,696,819,802,1165,670,17,11,17011,2141,2762,4596,3194,2049,2691,4623,3969,4190,5453,9219,7163,33122,16334,16788,30937,350,291,1022,3029,57436,6916,16571.0,17182.0
313,"Coles County, Illinois",24877,1175,1337,797,1203,1225,1405,716,17,29,17029,6089,4420,5962,3700,6754,4146,6232,4795,12843,8566,12194,8495,51353,24877,26476,47722,2019,625,104,1300,46202,9825,21863.0,22470.0
314,"Crawford County, Illinois",9906,506,532,328,511,493,546,327,17,33,17033,1603,2136,2735,1546,1143,1549,2485,2012,2746,3685,5220,3558,18972,9906,9066,17119,1231,61,75,621,49779,3221,8728.0,9419.0
315,"Putnam County, Illinois",2962,130,178,116,109,137,138,104,17,155,17155,368,459,889,619,297,449,846,679,665,908,1735,1298,5721,2962,2759,5532,40,46,36,320,63638,1184,3111.0,3345.0
316,"De Witt County, Illinois",7947,407,483,322,450,444,475,328,17,39,17039,1021,1482,2365,1333,930,1435,2266,1657,1951,2917,4631,2990,15932,7947,7985,15305,85,4,207,436,55587,3656,7543.0,7994.0
317,"Lee County, Illinois",18299,824,1204,650,893,940,941,567,17,103,17103,2713,3721,5339,3055,2124,2609,4560,3456,4837,6330,9899,6511,34389,18299,16090,31133,1881,193,357,2139,58194,6816,15489.0,16351.0
318,"Macoupin County, Illinois",22535,1208,1456,919,1084,1196,1442,849,17,117,17117,2992,3954,6507,3970,2879,4015,6538,4925,5871,7969,13045,8895,45463,22535,22928,43970,434,222,139,560,55159,9885,22360.0,23919.0
319,"Richland County, Illinois",7797,523,475,310,528,460,533,268,17,159,17159,1113,1338,2098,1411,951,1336,2138,1755,2064,2674,4236,3166,15766,7797,7969,15178,125,80,92,270,48894,3009,7684.0,9343.0
320,"Washington County, Illinois",7068,408,385,272,378,490,319,276,17,189,17189,905,1226,2054,1308,871,1181,1987,1488,1776,2407,4041,2796,14058,7068,6990,13594,121,41,90,203,61763,2998,7427.0,7914.0
321,"Washington County, Oregon",291701,18473,19262,11815,17498,19266,18642,11300,41,67,41067,47144,68950,72424,32997,46057,67133,74520,43364,93201,136083,146944,76361,589481,291701,297780,447201,11897,62545,29894,98201,82215,137189,269232.0,314751.0
322,"Clatsop County, Oregon",19457,1163,966,700,851,800,1312,615,41,7,41007,2802,3544,5298,3931,2588,3481,5542,4456,5390,7025,10840,8387,39102,19457,19645,35929,314,387,377,3329,54886,7721,19664.0,22758.0
323,"Cameron County, Pennsylvania",2281,133,112,54,74,87,95,115,42,23,42023,271,319,704,591,245,292,778,644,516,611,1482,1235,4611,2281,2330,4449,4,39,9,51,41165,977,2186.0,2440.0
324,"Bucks County, Pennsylvania",307660,15498,17230,13070,14796,16684,19324,12166,42,17,42017,43208,53783,93802,50668,40984,54677,97465,63050,84192,108460,191267,113718,626806,307660,319146,548891,25325,30282,8339,33339,89139,161165,344297.0,385933.0
325,"Lehigh County, Pennsylvania",178570,11074,11453,7561,10467,10888,11459,7214,42,77,42077,28745,34404,46593,26070,28698,34476,49248,34032,57443,68880,95841,60102,365052,178570,186482,289545,26932,12220,22460,89367,63897,75874,160993.0,179770.0
326,"Clarion County, Pennsylvania",18881,1042,1118,631,943,886,1100,647,42,31,42031,3658,2966,5184,3344,3880,3005,5304,4069,7538,5971,10488,7413,38715,18881,19834,37325,527,231,24,373,46680,9520,17535.0,19234.0
327,"Greene County, Pennsylvania",19169,1011,937,649,931,961,953,579,42,59,42059,3178,3676,5478,3151,2693,2933,4979,3672,5871,6609,10457,6823,36870,19169,17701,34669,1152,132,104,563,54776,8888,15764.0,17494.0
328,"Luzerne County, Pennsylvania",157010,8228,8606,5907,8085,8227,8826,5517,42,79,42079,25757,28546,44122,26685,23121,27006,44271,35600,48878,55552,88393,62285,317663,157010,160653,278303,16212,3968,11920,37790,53473,68846,134983.0,149103.0
329,"Columbia County, Pennsylvania",31564,1474,1410,1016,1466,1548,1721,1026,42,37,42037,6509,5199,8577,5434,7361,4891,9129,7009,13870,10090,17706,12443,65715,31564,34151,62515,1177,735,460,1810,50550,14620,28228.0,30669.0
330,"Jefferson County, Pennsylvania",21839,1280,1348,857,1208,1283,1238,782,42,65,42065,3014,3700,6264,4056,2874,3518,6147,4957,5888,7218,12411,9013,43846,21839,22007,42903,231,121,67,403,47603,10471,19478.0,22799.0
331,"Perry County, Pennsylvania",23346,1371,1499,982,1274,1241,1376,793,42,99,42099,3199,3985,6968,3936,2919,3959,6788,4357,6118,7944,13756,8293,46053,23346,22707,44605,438,162,186,939,63718,10794,21158.0,24032.0
332,"Sullivan County, Pennsylvania",3243,100,83,122,95,86,82,64,42,113,42113,489,459,1077,825,309,422,963,871,798,881,2040,1696,6135,3243,2892,5866,150,5,65,112,47407,1733,3136.0,3602.0
333,"Kent County, Rhode Island",79292,4134,4280,2903,3943,4324,4118,2733,44,3,44003,11514,15088,23858,12890,11005,15399,25765,17290,22519,30487,49623,30180,163869,79292,84577,149642,3157,4474,2304,8157,73521,39045,82053.0,91475.0
334,"Washington County, Rhode Island",60774,2378,2684,2185,2293,3041,2929,2235,44,9,44009,12119,8732,17987,11205,12535,8867,19469,13917,24654,17599,37456,25122,126060,60774,65286,117049,1736,2431,1344,4039,85531,31070,66369.0,74325.0
335,"Newberry County, South Carolina",18529,1102,1246,652,1135,1194,1063,845,45,71,45071,3177,3058,4982,3213,2832,3131,5333,4132,6009,6189,10315,7345,38194,18529,19665,24134,11878,93,1619,2854,44226,5775,16807.0,18631.0
336,"Clarendon County, South Carolina",16739,832,954,645,791,1151,732,571,45,27,45027,2994,2522,4318,3523,2123,2664,4974,4212,5117,5186,9292,7735,33957,16739,17218,16729,16124,201,414,1054,40900,4769,15395.0,16733.0
337,"Sumter County, South Carolina",51432,3670,3516,2156,3439,3677,3289,2259,45,85,45085,9841,9117,12173,7120,8980,9537,14316,9828,18821,18654,26489,16948,106757,51432,55325,50412,49908,1467,1209,4225,45661,14628,44086.0,48920.0
338,"Barnwell County, South Carolina",10337,816,774,462,510,686,734,465,45,11,45011,1620,1589,2716,1656,1517,1861,3106,2130,3137,3450,5822,3786,21346,10337,11009,10863,9785,36,421,524,35803,2761,9485.0,10321.0
339,"Darlington County, South Carolina",31723,2014,2195,1383,1894,1695,2412,1379,45,31,45031,4925,5331,8486,5330,5236,5942,9748,6998,10161,11273,18234,12328,67027,31723,35304,37941,27547,247,21,1368,38448,10331,29674.0,32417.0
340,"York County, South Carolina",128270,8328,8916,5603,7864,9247,9151,5568,45,91,45091,18553,25612,34569,16571,19995,27914,37093,20770,38548,53526,71662,37341,265872,128270,137602,197372,50998,5673,4280,14638,65361,52023,114357.0,144050.0
341,"Cherokee County, South Carolina",27531,1592,1699,1099,1722,1822,1883,1231,45,21,45021,4590,4719,7578,4080,4572,5356,7596,5182,9162,10075,15174,9262,56895,27531,29364,42974,11421,332,645,2479,36883,8006,21759.0,25270.0
342,"Jasper County, South Carolina",14375,957,717,388,769,1037,723,453,45,53,45053,2536,2916,3551,2357,1984,2482,3979,2855,4520,5398,7530,5212,28657,14375,14282,15011,11909,120,978,3851,45601,3951,11427.0,14889.0
343,"Lee County, South Carolina",8865,414,381,306,441,491,438,326,45,61,45061,1859,1664,2306,1331,1153,1306,2536,1809,3012,2970,4842,3140,17365,8865,8500,5721,11163,8,255,426,32371,2312,8156.0,8431.0
344,"Abbeville County, South Carolina",11941,643,633,477,648,578,795,455,45,1,45001,1858,1849,3288,2345,1864,1938,3551,2857,3722,3787,6839,5202,24627,11941,12686,17221,6804,79,37,367,38741,3247,10775.0,14552.0
345,"Lyman County, South Dakota",2004,186,148,98,164,157,133,80,46,85,46085,303,348,472,283,252,308,434,316,555,656,906,599,3848,2004,1844,2167,4,24,0,49,53862,647,1421.0,1597.0
346,"Deuel County, South Dakota",2250,167,158,93,112,133,137,75,46,39,46039,241,408,604,427,244,321,554,492,485,729,1158,919,4318,2250,2068,4282,1,0,6,148,65437,972,2080.0,2350.0
347,"Glenn County, California",14218,1159,995,660,890,781,1210,636,6,21,06021,2237,2525,3407,2081,2052,2520,3290,2379,4289,5045,6697,4460,27976,14218,13758,22685,230,825,2898,11680,49633,3765,9470.0,9639.0
348,"Butte County, California",111735,6395,6941,4080,5989,6780,5662,3607,6,7,06007,24821,19304,25922,18287,23840,18306,27500,22398,48661,37610,53422,40685,225817,111735,114082,184180,3461,10432,10754,36916,52537,37024,95564.0,97720.0
349,"Kings County, California",82995,5955,5478,3247,5687,5922,5489,3071,6,31,06031,17677,19558,17945,6945,12378,13155,13876,8118,30055,32713,31821,15063,150691,82995,67696,102062,9642,5817,24319,82116,57848,18450,33915.0,41935.0
350,"Plumas County, California",9282,420,411,261,388,485,455,267,6,63,06063,1101,1261,2862,2536,925,1389,2955,2514,2026,2650,5817,5050,18660,9282,9378,16855,166,222,295,1670,55359,3710,9676.0,10950.0
351,"San Luis Obispo County, California",143006,6678,7237,4331,6476,6544,7311,4244,6,79,06079,32157,24973,34882,25393,27239,22137,35754,29454,59396,47110,70636,54847,282165,143006,139159,241123,5319,10296,12267,63534,73518,53309,135009.0,132646.0
352,"Fresno County, California",491146,39692,39372,22653,38019,38460,38970,22092,6,19,06019,91459,98533,105210,52641,87545,95246,107907,65136,179004,193779,213117,117777,984521,491146,493375,639985,46782,101857,142237,522364,53969,132898,282319.0,323722.0
353,"Kern County, California",454843,35815,35873,21196,34454,35541,36652,20291,6,29,06029,88018,94444,97712,43518,75772,83191,95703,51194,163790,177635,193415,94712,887641,454843,432798,660147,48550,42100,95165,473374,53350,117033,244163.0,143486.0
354,"Orange County, California",1563832,96241,95037,63648,91582,91347,100123,61263,6,59,06059,273359,314466,414314,201500,261364,314435,430493,253605,534723,628901,844807,455105,3168044,1563832,1604212,1931263,55591,649042,377563,1078726,90234,714563,1197521.0,1418956.0
355,"Ventura County, California",419111,25795,26436,17629,24730,25684,29383,17212,6,111,06111,71456,80520,110206,57151,67402,78908,114356,70477,138858,159428,224562,127628,847263,419111,428152,678658,15594,62190,44227,361601,88131,164684,351726.0,358813.0
356,"Calaveras County, California",22663,920,1253,825,982,1115,1064,675,6,9,06009,2624,3186,6743,6135,2292,3193,7146,6384,4916,6379,13889,12519,45514,22663,22851,41173,315,684,608,5489,63158,8146,23136.0,22506.0
357,"Sutter County, California",47866,3372,3668,2185,3185,3470,3442,2012,6,101,06101,7995,9068,11351,6502,7416,9144,11658,7916,15411,18212,23009,14418,96109,47866,48243,66293,1827,15048,4730,29748,59050,12924,33523.0,35969.0
358,"San Mateo County, California",379328,22587,23697,13661,21353,21255,22456,12648,6,81,06081,58057,85567,101163,52749,53247,83313,105695,68128,111304,168880,206858,120877,767423,379328,388095,388318,17784,220151,84310,187248,122641,223272,314384.0,284272.0
359,"Tuolumne County, California",28112,1219,1451,749,1215,1174,1252,781,6,109,06109,4136,5230,7523,6658,2961,3802,7579,7169,7097,9032,15102,13827,54045,28112,25933,47447,984,754,1406,6617,60108,9967,25529.0,29820.0
360,"San Joaquin County, California",370152,26799,29303,17865,25589,28233,28155,16717,6,77,06077,64953,73528,86589,41075,60791,72779,88181,52006,125744,146307,174770,93081,742603,370152,372451,419288,51931,115531,65384,307463,64432,106352,224166.0,155165.0
361,"Amador County, California",20640,796,730,570,731,683,994,494,6,5,06005,2567,3920,6311,4897,1794,2417,5327,5349,4361,6337,11638,10246,38429,20640,17789,33327,904,508,1500,5340,62772,7202,17734.0,22234.0
362,"Phillips County, Colorado",2226,98,149,120,261,149,172,35,8,95,08095,453,423,467,357,197,338,528,384,650,761,995,741,4290,2226,2064,4146,9,22,48,1027,51155,855,2332.0,2461.0
363,"Archuleta County, Colorado",6657,327,359,184,275,323,359,126,8,7,08007,755,1018,1979,1686,606,1079,2130,1698,1361,2097,4109,3384,13253,6657,6596,11136,230,126,1368,2435,52221,2996,7339.0,9030.0
364,"Denver County, Colorado",353311,21734,20526,10043,21096,19941,18070,9705,8,31,08031,69532,99748,77614,35542,70581,92130,74796,45946,140113,191878,152410,81488,705576,353311,352265,537029,65215,26156,43220,210937,68592,175927,331852.0,350606.0
365,"Kiowa County, Colorado",722,82,31,25,95,29,23,12,8,61,08061,80,121,145,142,81,94,207,226,161,215,352,368,1489,722,767,1433,6,0,4,72,41731,289,855.0,902.0
366,"Huerfano County, Colorado",3288,70,204,54,162,149,137,90,8,55,08055,286,463,935,1068,278,473,1087,1015,564,936,2022,2083,6679,3288,3391,6140,34,0,103,2290,38137,1389,3783.0,4389.0
367,"Baca County, Colorado",1744,96,130,52,84,104,111,67,8,9,08009,200,323,441,398,186,286,451,528,386,609,892,926,3561,1744,1817,3357,34,0,29,390,35878,685,2153.0,2193.0
368,"Gilpin County, Colorado",3048,92,123,69,52,150,115,76,8,47,08047,285,661,1115,562,247,533,1280,517,532,1194,2395,1079,6018,3048,2970,5562,20,0,3,503,76429,1590,3576.0,4143.0
369,"Kit Carson County, Colorado",3994,248,292,164,177,273,244,110,8,63,08063,483,913,967,639,450,566,907,726,933,1479,1874,1365,7447,3994,3453,6861,186,14,281,1421,49349,1564,3702.0,3792.0
370,"Gunnison County, Colorado",9101,368,453,284,371,328,409,262,8,51,08051,2491,1763,2125,1184,1934,1489,1906,1002,4425,3252,4031,2186,16802,9101,7701,16083,95,57,42,1583,56577,4068,9412.0,10887.0
371,"Mineral County, Colorado",422,15,10,2,0,32,2,11,8,79,08079,31,73,151,116,38,51,163,105,69,124,314,221,824,422,402,720,9,4,43,79,62188,223,652.0,754.0
372,"Ouray County, Colorado",2437,135,77,66,70,71,119,68,8,91,08091,187,450,650,715,161,347,908,615,348,797,1558,1330,4796,2437,2359,4684,15,35,3,97,66417,1334,3310.0,3960.0
373,"Sedgwick County, Colorado",1109,95,80,24,145,49,80,66,8,115,08115,112,196,312,245,99,177,305,292,211,373,617,537,2322,1109,1213,2175,19,22,58,312,43150,370,1364.0,1441.0
374,"Weld County, Colorado",154294,11237,12414,6542,10816,11608,10515,6292,8,123,08123,26109,33584,36504,16926,25328,31147,36054,19291,51437,64731,72558,36217,305345,154294,151051,275792,3643,4833,9209,89924,74150,57244,135428.0,164791.0
375,"Custer County, Colorado",2442,42,72,102,7,110,157,74,8,27,08027,145,229,817,883,194,226,732,834,339,455,1549,1717,4776,2442,2334,4441,138,0,38,440,53119,1107,3066.0,3586.0
376,"Costilla County, Colorado",1985,80,70,108,76,76,88,56,8,23,08023,250,203,610,534,194,290,491,489,444,493,1101,1023,3745,1985,1760,3311,14,48,145,2317,30965,624,1848.0,2031.0
377,"Douglas County, Colorado",167729,10336,11939,8701,9544,11984,13531,8272,8,35,08035,21073,35226,47659,17867,20230,35836,48365,20550,41303,71062,96024,38417,336041,167729,168312,298665,4874,16079,4923,29211,119730,80079,187499.0,230478.0
378,"Lake County, Colorado",4308,178,305,172,21,192,227,147,8,65,08065,862,848,1352,433,830,875,766,385,1692,1723,2118,818,7751,4308,3443,6614,9,65,816,2508,50565,1697,3199.0,3938.0
379,"La Plata County, Colorado",27999,1497,1419,870,1403,1523,1375,846,8,67,08067,4668,5763,7579,4526,4436,5374,8037,4624,9104,11137,15616,9150,55617,27999,27618,48924,276,406,1046,7110,68685,13635,31150.0,35377.0
380,"Pitkin County, Colorado",9344,458,626,136,360,226,396,369,8,97,08097,1375,1866,2861,1711,1531,1620,2599,1481,2906,3486,5460,3192,17926,9344,8582,16339,174,403,742,1809,78935,4948,10523.0,11829.0
381,"Rio Grande County, Colorado",5632,274,251,365,373,355,343,169,8,105,08105,784,1051,1373,1053,775,994,1521,1143,1559,2045,2894,2196,11305,5632,5673,10346,106,8,326,5020,39123,2252,5534.0,6280.0
382,"Bent County, Colorado",3735,73,147,64,124,100,180,91,8,11,08011,729,1225,882,516,193,382,465,517,922,1607,1347,1033,5787,3735,2052,5287,238,12,108,1855,30900,1852,1927.0,2229.0
383,"Crowley County, Colorado",3654,111,132,77,53,94,131,47,8,25,08025,948,945,966,411,590,329,497,359,1538,1274,1463,770,5754,3654,2100,5098,203,34,65,1833,42135,1237,1527.0,1730.0
384,"San Juan County, Colorado",292,0,7,9,25,0,24,0,8,111,08111,44,51,102,68,22,38,110,78,66,89,212,146,589,292,297,573,0,0,0,50,54625,137,506.0,563.0
385,"Larimer County, Colorado",172000,8955,9622,6073,8776,9002,10031,5661,8,69,08069,39396,33705,40046,23933,37215,31733,42140,28228,76611,65438,82186,52161,344786,172000,172786,314957,3387,7546,5029,39686,71881,78724,195980.0,223653.0
386,"Logan County, Colorado",12086,740,524,406,910,431,571,416,8,75,08075,2492,2434,3158,1732,1704,1581,2575,2106,4196,4015,5733,3838,22380,12086,10294,20452,189,185,251,3749,53318,4855,9722.0,10411.0
387,"San Miguel County, Colorado",4240,163,212,105,139,185,249,105,8,113,08113,581,977,1320,595,597,919,1122,493,1178,1896,2442,1088,8049,4240,3809,7619,1,149,84,859,67038,2348,4329.0,5057.0
388,"Teller County, Colorado",12480,485,654,450,413,559,792,376,8,119,08119,1453,1823,4375,2646,1223,1820,4344,2517,2676,3643,8719,5163,24524,12480,12044,23221,208,193,131,1614,66592,5948,14444.0,16793.0
389,"Elbert County, Colorado",13020,600,733,606,541,777,774,600,8,39,08039,1548,1957,4613,2022,1349,2088,4606,1962,2897,4045,9219,3984,25717,13020,12697,24062,110,259,255,1799,99199,5480,15978.0,18554.0
390,"Las Animas County, Colorado",7485,306,345,229,314,423,267,230,8,71,08071,1321,1274,1978,1614,833,1034,1917,1763,2154,2308,3895,3377,14266,7485,6781,12111,125,137,603,5921,41817,2692,6793.0,7897.0
391,"Lincoln County, Colorado",3561,156,174,97,152,152,140,91,8,73,08073,753,1034,729,457,91,280,604,514,844,1314,1333,971,5585,3561,2024,4971,459,23,21,1259,47258,1749,2436.0,2630.0
392,"Summit County, Colorado",16696,697,826,357,612,590,833,464,8,117,08117,2974,4280,4910,2054,2328,3362,3904,1860,5302,7642,8814,3914,30649,16696,13953,27978,342,179,1380,4382,79277,8607,16174.0,18330.0
393,"Alamosa County, Colorado",8059,551,512,285,565,501,557,293,8,3,08003,1944,1464,1629,1005,1821,1405,1781,1125,3765,2869,3410,2130,16107,8059,8048,13918,144,213,783,7533,37515,2822,6939.0,7519.0
394,"Delta County, Colorado",15453,831,947,635,677,695,1062,490,8,29,08029,1915,2698,4005,3678,1566,2234,4339,4049,3481,4932,8344,7727,30565,15453,15112,28866,367,323,273,4649,45269,7057,16790.0,19272.0
395,"Fremont County, Colorado",27599,965,1080,756,882,1101,984,693,8,43,08043,3915,7148,7796,4905,2090,2955,5912,5105,6005,10103,13708,10010,47321,27599,19722,42504,2177,320,617,6288,49409,11970,21973.0,25058.0
396,"Montrose County, Colorado",20526,1195,949,818,1140,1458,1068,780,8,85,08085,2517,3394,5512,4470,2356,3420,5773,5165,4873,6814,11285,9635,41686,20526,21160,39254,163,386,695,8596,50489,8382,21186.0,24764.0
397,"Morgan County, Colorado",14348,1025,1182,654,1027,1030,1017,564,8,87,08087,2394,2718,3528,1920,2142,2545,3380,2464,4536,5263,6908,4384,28517,14348,14169,25319,1038,152,862,10306,53682,4540,11960.0,13415.0
398,"Saguache County, Colorado",3283,126,213,174,220,246,211,73,8,109,08109,317,495,1038,746,294,505,1031,729,611,1000,2069,1475,6592,3283,3309,5948,33,0,189,2394,38571,1426,2835.0,3337.0
399,"Prowers County, Colorado",6132,427,458,336,387,389,436,182,8,99,08099,1011,1007,1506,931,830,1001,1504,1161,1841,2008,3010,2092,12022,6132,5890,11351,95,70,123,4573,41929,1773,5016.0,5507.0
400,"Washington County, Colorado",2550,139,170,109,114,127,157,98,8,121,08121,347,470,641,477,316,369,637,500,663,839,1278,977,4868,2550,2318,4641,63,29,53,488,50094,945,2733.0,2943.0
401,"Grand County, Colorado",8087,295,350,247,280,299,449,293,8,49,08049,1099,1783,2446,1411,996,1361,2388,1150,2095,3144,4834,2561,15303,8087,7216,14510,172,213,213,1350,71198,3443,8588.0,9606.0
402,"Otero County, Colorado",8904,519,473,428,558,685,586,359,8,89,08089,1379,1519,2126,1658,1247,1707,2223,2013,2626,3226,4349,3671,18282,8904,9378,16479,113,167,732,7658,38169,3298,8452.0,9459.0
403,"Broomfield County, Colorado",33817,1857,2297,1489,1841,2213,2296,1385,8,14,08014,5357,7790,8747,3917,5024,7309,8892,5109,10381,15099,17639,9026,67886,33817,34069,58579,875,4420,1271,8404,96416,17445,37689.0,46297.0
404,"Sussex County, Delaware",108502,5715,5541,3509,5744,5586,6254,3397,10,5,10005,13257,16327,29454,28171,12586,16610,33387,32318,25843,32937,62841,60489,224384,108502,115882,184098,26918,2753,4384,20577,63162,48333,106008.0,129293.0
405,"District of Columbia, District of Columbia",328644,22874,17846,7905,22166,16415,14948,7779,11,1,11001,71951,88303,71506,34262,85479,93077,74767,49408,157430,181380,146273,83670,692683,328644,364039,285857,320811,27592,34511,76191,86420,193806,311268.0,31260.0
406,"New Haven County, Connecticut",413519,22957,23219,16718,21546,23306,24497,15976,9,9,09009,72205,76127,113509,62169,71408,80759,122930,83572,143613,156886,236439,145741,857513,413519,443994,628640,115837,34656,48622,155335,69905,197363,379006.0,397744.0
407,"Hartford County, Connecticut",433975,24427,25352,17964,23376,24540,27819,17127,9,3,09003,72060,83364,118469,63767,67812,85003,127787,86122,139872,168367,246256,149889,893561,433975,459586,631471,123117,47734,56134,161079,75148,205247,406864.0,444223.0
408,"Shelby County, Tennessee",444834,33572,31264,19532,32681,31672,32534,19195,47,157,47157,79456,86408,109018,50853,82125,95297,126194,71842,161581,181705,235212,122695,936374,444834,491540,366180,502669,24626,25456,59571,51657,162131,337383.0,381858.0
409,"Henderson County, Tennessee",13721,822,1201,572,683,855,844,583,47,77,47077,1864,2363,3858,2213,1950,2584,3951,2806,3814,4947,7809,5019,27977,13721,14256,25091,2192,35,31,678,43305,5003,10217.0,12020.0
410,"Jefferson County, Tennessee",26332,1297,1624,1018,1292,1570,1386,1043,47,89,47089,4155,4363,7546,4851,3987,4419,7963,5687,8142,8782,15509,10538,53679,26332,27347,51204,910,345,161,1928,49139,10878,19072.0,23562.0
411,"Sequatchie County, Tennessee",7391,367,362,341,349,395,435,311,47,153,47153,1033,1372,2081,1381,926,1272,2157,1580,1959,2644,4238,2961,14816,7391,7425,14382,33,0,10,525,49370,2887,5694.0,7239.0
412,"Carroll County, Tennessee",13613,823,730,575,778,892,730,419,47,17,47017,2253,2058,3766,2398,2140,2227,3930,3157,4393,4285,7696,5555,27886,13613,14273,24211,2867,113,30,741,42637,5458,10384.0,11893.0
413,"Davidson County, Tennessee",331298,23667,20098,10536,22737,20525,18024,10187,47,37,47037,67253,79085,76880,34547,73700,79624,83733,47660,140953,158709,160613,82207,687488,331298,356190,440299,186295,24865,16136,70319,60388,159964,249068.0,308325.0
414,"Perry County, Tennessee",3941,263,211,143,237,231,212,211,47,135,47135,577,628,1094,773,504,671,1096,859,1081,1299,2190,1632,7962,3941,4021,7372,218,178,31,108,41034,1437,2855.0,3428.0
415,"Meigs County, Tennessee",5991,292,347,246,334,197,503,232,47,121,47121,731,1027,1702,1316,715,988,1830,1314,1446,2015,3532,2630,12104,5991,6113,11630,230,26,0,255,49167,2406,4320.0,5529.0
416,"Haywood County, Tennessee",8238,537,698,369,515,436,665,341,47,75,47075,1156,1403,2313,1324,1230,1696,2674,1828,2386,3099,4987,3152,17623,8238,9385,8243,8950,8,238,762,37905,2307,6834.0,7420.0
417,"Montgomery County, Tennessee",99949,8745,7312,3973,8119,7332,7014,3785,47,125,47125,22564,22247,19439,8107,20693,21760,21372,10156,43257,44007,40811,18263,200180,99949,100231,141131,40208,4409,3023,20036,57541,36484,57620.0,76678.0
418,"Grundy County, Tennessee",6599,396,421,269,362,380,362,257,47,61,47061,932,1115,1816,1203,901,1151,1795,1537,1833,2266,3611,2740,13344,6599,6745,11758,96,26,12,167,40516,2557,4763.0,5844.0
419,"Cocke County, Tennessee",17255,972,1066,667,1026,774,1170,591,47,29,47029,2280,2742,4950,3534,2392,2953,5512,3879,4672,5695,10462,7413,35552,17255,18297,33687,662,67,20,837,36716,7086,12126.0,14870.0
420,"DeKalb County, Tennessee",9857,527,646,453,605,568,522,370,47,41,47041,1252,1925,2808,1605,1318,1795,2823,1989,2570,3720,5631,3594,19847,9857,9990,18582,360,54,465,1639,45511,4135,6955.0,8501.0
421,"Lewis County, Tennessee",5823,304,342,278,352,318,392,207,47,101,47101,772,1013,1575,1104,842,1019,1707,1367,1614,2032,3282,2471,12027,5823,6204,11436,219,164,53,276,37277,2256,4622.0,5604.0
422,"Obion County, Tennessee",14609,891,824,585,835,894,950,659,47,131,47131,2079,2557,3999,2652,2065,2715,4266,3372,4144,5272,8265,6024,30365,14609,15756,25859,3126,116,551,1339,39615,5818,12249.0,13521.0
423,"Tipton County, Tennessee",30265,1957,2149,1413,1777,2200,2006,1365,47,167,47167,4739,5630,8228,3872,4444,5984,8627,4779,9183,11614,16855,8651,61447,30265,31182,47750,11313,520,380,1708,61291,10038,23481.0,27291.0
424,"Dyer County, Tennessee",18137,1150,1216,814,1078,937,1459,842,47,45,47045,2684,3193,4876,2748,2678,3498,5104,3683,5362,6691,9980,6431,37416,18137,19279,30612,4836,290,348,1274,44185,6716,13336.0,15074.0
425,"Hamilton County, Tennessee",174207,10611,10696,6304,10267,9953,10584,6022,47,65,47065,28971,34340,45510,26919,30198,34928,49538,35222,59169,69268,95048,62141,360919,174207,186712,271750,69100,7445,4181,20391,55070,72200,142408.0,170735.0
426,"Polk County, Tennessee",8366,383,316,353,416,449,509,304,47,139,47139,1131,1379,2579,1619,970,1408,2562,1830,2101,2787,5141,3449,16814,8366,8448,16160,56,17,179,353,43306,3225,6520.0,8360.0
427,"White County, Tennessee",13070,854,805,512,760,698,947,483,47,185,47185,1851,2201,3527,2408,1766,2314,3796,2966,3617,4515,7323,5374,26800,13070,13730,25710,568,47,0,690,41998,5697,9825.0,11867.0
428,"Sullivan County, Tennessee",76345,4030,4394,2908,3709,3937,4506,2776,47,163,47163,10967,12959,21861,14909,10292,13455,23186,18844,21259,26414,45047,33753,157050,76345,80705,148183,3067,953,1017,2978,46684,33082,62278.0,74206.0
429,"Schoharie County, New York",15500,686,902,524,630,729,834,554,36,95,36095,2538,2436,4563,3167,2509,2397,4683,3386,5047,4833,9246,6553,31222,15500,15722,29791,496,281,170,998,57714,7013,14050.0,13374.0
430,"Fulton County, New York",26800,1410,1589,1018,1300,1372,1608,986,36,35,36035,3873,4788,7903,4566,3417,4642,7876,5645,7290,9430,15779,10211,53646,26800,26846,50640,1119,417,444,1662,50482,10470,21214.0,20153.0
431,"Rensselaer County, New York",78848,4216,4643,2861,4070,3895,4381,2670,36,83,36083,15094,14517,21545,11627,12820,14976,22845,14680,27914,29493,44390,26307,159185,78848,80337,137002,10268,4282,1675,7842,68991,34627,71562.0,65285.0
432,"Franklin County, New York",27483,1275,1451,969,1210,1598,1301,806,36,33,36033,5804,5303,7287,3944,3192,3893,6573,4421,8996,9196,13860,8365,50477,27483,22994,41726,2863,280,1057,1789,50407,10210,16952.0,15397.0
433,"Queens County, New York",1109772,73502,61837,37134,69577,59184,61109,35358,36,81,36081,183407,247892,293967,147411,185222,248664,315399,203103,368629,496556,609366,350514,2287388,1109772,1177616,875191,418429,583459,316141,641496,68666,499334,686393.0,946572.0
434,"Washington County, New York",31902,1447,1896,1061,1449,1577,1564,1066,36,115,36115,4921,6003,9513,5385,3662,5100,9061,6235,8583,11103,18574,11620,61616,31902,29714,57686,1969,371,518,1691,57258,14322,24528.0,23607.0
435,"New York County, New York",772614,40100,30450,16735,38673,31297,29428,17026,36,61,36061,156255,201552,188367,107928,182327,206150,198050,156428,338582,407702,386417,264356,1631993,772614,859379,922033,240993,198833,188400,421540,86553,518531,668939.0,446861.0
436,"Cayuga County, New York",39757,2044,2172,1509,1846,2080,2057,1386,36,11,36011,6165,7397,11617,6553,5263,6289,11088,7659,11428,13686,22705,14212,77425,39757,37668,71056,3303,441,604,2286,58377,16023,33172.0,30296.0
437,"Rockland County, New York",159114,12943,12920,7761,12710,11793,12682,7362,36,87,36087,25405,27007,38754,21603,23913,26844,41196,28808,49318,53851,79950,50411,324422,159114,165308,229240,39845,19099,26993,57447,93024,67200,135087.0,116024.0
438,"Niagara County, New York",102775,5650,5147,4030,5449,5534,6112,3785,36,63,36063,15904,17714,30289,17224,15419,18253,31500,21993,31323,35967,61789,39217,210820,102775,108045,183860,14806,2337,1683,6364,55522,43363,92402.0,87821.0
439,"Essex County, New York",19504,776,843,693,702,857,822,575,36,31,36031,2945,3493,5821,4047,2042,2830,5649,4478,4987,6323,11470,8525,37459,19504,17955,34788,1194,103,506,1129,56763,9548,17218.0,15185.0
440,"Nassau County, New York",660093,38004,41568,27920,36224,39327,41090,26495,36,59,36059,102129,118156,186580,102622,97799,120792,200328,134361,199928,238948,386908,236983,1356509,660093,696416,922873,158857,130971,98388,229281,116100,346936,636967.0,572706.0
441,"Schuyler County, New York",8965,475,425,350,424,460,451,323,36,97,36097,1254,1387,2779,1753,1115,1437,2771,1974,2369,2824,5550,3727,17920,8965,8955,17289,182,126,42,333,52327,4176,8772.0,8220.0
442,"Chenango County, New York",24003,1296,1264,914,1260,1395,1315,904,36,17,36017,3320,3933,7094,4579,3074,3744,7116,5098,6394,7677,14210,9677,47909,24003,23906,46037,467,218,202,1049,52002,10521,20160.0,17241.0
443,"Jefferson County, New York",59266,4527,4000,1951,4391,3765,3311,1928,36,45,36045,15016,11513,12160,6690,9688,9886,12374,8233,24704,21399,24534,14923,112842,59266,53576,97448,6932,1983,1325,8489,52685,21536,38236.0,35530.0
444,"Suffolk County, New York",730427,40470,41718,30974,39329,41010,45669,29758,36,103,36103,116580,130280,214176,106944,109038,128532,222142,137927,225618,258812,436318,244871,1483832,730427,753405,1196719,116018,58204,74432,286577,101031,335811,681254.0,598129.0
445,"Wyoming County, New York",21537,1003,1074,761,1077,1108,1074,732,36,121,36121,3583,4205,6358,3366,2542,3045,5560,3630,6125,7250,11918,6996,40305,21537,18768,36882,1669,167,569,1326,58052,9278,17298.0,17162.0
446,"Oswego County, New York",59267,3332,3484,2391,3132,3191,3628,2172,36,75,36075,10564,9815,17257,8632,10006,9827,17080,10036,20570,19642,34337,18668,118339,59267,59072,113114,1352,884,601,3068,55967,24074,48180.0,44546.0
447,"Wayne County, New York",44902,2567,2608,1703,2397,2628,2800,1775,36,117,36117,6253,7569,13491,7699,5843,7413,13829,8932,12096,14982,27320,16631,90519,44902,45617,84123,2543,725,960,3992,59449,19376,39687.0,37425.0
448,"Broome County, New York",95077,5243,5785,3522,4863,4957,5025,3293,36,7,36007,19902,15028,25029,15628,18735,15142,25617,20479,38637,30170,50646,36107,193188,95077,98111,165108,10918,8389,2058,8140,52226,38006,86072.0,72251.0
449,"Hinsdale County, Colorado",385,13,2,21,24,18,24,18,8,53,08053,37,34,157,103,21,71,189,107,58,105,346,210,857,385,472,807,0,4,8,49,56339,255,589.0,632.0
450,"Erie County, New York",444825,25735,25202,17403,24615,25396,25359,16707,36,29,36029,77890,81215,121274,68951,76410,82432,130818,92793,154300,163647,252092,161744,919355,444825,474530,715409,123742,32793,20349,50599,58121,201791,423625.0,383952.0
451,"Sullivan County, New York",38485,2196,2149,1391,2061,1976,2307,1444,36,105,36105,5566,6775,11267,6723,4876,6209,10553,7205,10442,12984,21820,13928,75116,38485,36631,59949,5990,1265,4283,12009,57426,16043,29955.0,26931.0
452,"Orange County, New York",190453,12941,13595,8973,12212,13121,13435,8465,36,71,36071,34071,33247,50144,22932,28230,33576,51574,29019,62301,66823,101718,51951,380085,190453,189632,281683,41779,10280,31086,77882,79944,74766,152021.0,139956.0
453,"Haywood County, North Carolina",29481,1573,1274,1070,1441,1351,1543,1025,37,87,37087,3759,4946,8296,6691,3777,5146,9115,8174,7536,10092,17411,14865,61053,29481,31572,58313,572,399,578,2425,51659,12706,30727.0,36265.0
454,"Forsyth County, North Carolina",177935,11552,12637,7701,11108,12344,11852,7347,37,67,37067,29481,32719,46583,24765,32336,36269,52300,33704,61817,68988,98883,58469,375195,177935,197260,247912,98362,8830,9028,48057,51569,74069,178312.0,198469.0
455,"Lake County, Indiana",234929,15012,15614,10546,14339,15410,16336,10305,18,89,18089,36600,44034,62107,33641,36143,46647,67135,44463,72743,90681,129242,78104,485707,234929,250778,300770,114891,6911,45169,92189,56128,86975,201205.0,220233.0
456,"Montgomery County, Indiana",19388,1166,1171,776,1096,1228,1186,738,18,107,18107,3361,3307,5289,2994,2527,3140,5168,3816,5888,6447,10457,6810,38287,19388,18899,36484,277,314,224,1836,55522,7843,15156.0,17197.0
457,"Adams County, Indiana",17650,1763,1748,850,1606,1371,1533,816,18,1,18001,2760,2776,4016,2335,2431,2870,4082,3017,5191,5646,8098,5352,35376,17650,17726,34113,399,104,460,1601,52504,5896,13090.0,14238.0
458,"Fayette County, Indiana",11402,608,744,506,599,653,773,494,18,41,18041,1667,1939,3122,2064,1506,2006,3273,2488,3173,3945,6395,4552,23194,11402,11792,22352,571,8,68,289,46175,4649,9530.0,10146.0
459,"Clay County, Indiana",12925,769,764,540,866,682,935,542,18,21,18021,1821,2381,3620,2101,1752,2322,3635,2575,3573,4703,7255,4676,26234,12925,13309,25311,220,73,39,142,55637,6038,11282.0,12277.0
460,"Dubois County, Indiana",21180,1496,1462,825,1334,1510,1362,936,18,37,18037,2857,3856,5991,3106,2778,3687,5691,4065,5635,7543,11682,7171,42543,21180,21363,40204,571,300,877,3329,60666,8895,19984.0,21805.0
461,"Franklin County, Indiana",11230,626,753,523,684,762,883,467,18,47,18047,1527,1870,3363,1827,1392,1958,3232,2166,2919,3828,6595,3993,22774,11230,11544,22199,33,205,31,183,62462,5354,11013.0,12018.0
462,"Hancock County, Indiana",37039,2217,2311,1662,2152,2367,2385,1684,18,59,18059,5291,6859,10313,5482,4936,7407,10705,6489,10227,14266,21018,11971,75164,37039,38125,70855,1780,604,443,1777,74072,17212,36181.0,42645.0
463,"Howard County, Indiana",39867,2629,2538,1591,2344,2379,2764,1658,18,67,18067,5883,6741,10931,6807,5788,7285,11363,8883,11671,14026,22294,15690,82331,39867,42464,71866,6389,1032,627,2769,52373,15713,36843.0,40619.0
464,"Ohio County, Indiana",2922,137,202,136,164,181,144,64,18,115,18115,348,495,935,568,341,474,920,664,689,969,1855,1232,5874,2922,2952,5694,23,26,43,74,60128,1254,2921.0,3164.0
465,"Parke County, Indiana",8170,527,557,328,523,448,489,285,18,121,18121,1031,1311,2368,1567,1293,1573,2493,1672,2324,2884,4861,3239,16946,8170,8776,16145,99,0,117,274,52618,3251,6582.0,7020.0
466,"Randolph County, Indiana",12214,704,612,553,746,860,746,528,18,135,18135,1667,2100,3443,2145,1653,2063,3354,2762,3320,4163,6797,4907,24926,12214,12712,23663,147,27,434,863,48036,5309,10458.0,11078.0
467,"Benton County, Indiana",4332,309,331,194,255,246,311,199,18,7,18007,615,741,1148,678,545,762,1185,842,1160,1503,2333,1520,8677,4332,4345,8448,43,7,24,452,49488,1858,3666.0,4115.0
468,"Brown County, Indiana",7354,291,346,285,292,409,392,260,18,13,18013,860,1131,2337,1699,817,1066,2512,1962,1677,2197,4849,3661,15064,7354,7710,14552,98,121,54,259,61030,3802,7945.0,8886.0
469,"Putnam County, Indiana",19760,951,1028,668,912,959,990,644,18,133,18133,4069,3832,5267,2809,3420,2713,4672,3314,7489,6545,9939,6123,37384,19760,17624,34845,955,926,148,721,61047,7716,14715.0,16595.0
470,"Washington County, Indiana",13885,801,844,591,802,790,1005,588,18,175,18175,2014,2481,4063,2142,1820,2402,4041,2515,3834,4883,8104,4657,27848,13885,13963,27291,26,95,35,374,47983,5839,11382.0,12126.0
471,"Daviess County, Indiana",16687,1373,1466,801,1227,1493,1147,783,18,27,18027,2562,2937,3874,2265,2464,2757,3798,2764,5026,5694,7672,5029,33120,16687,16433,31447,652,89,521,1646,53629,5165,10768.0,11971.0
472,"Henry County, Indiana",25389,1266,1340,979,1132,1479,1190,870,18,65,18065,4213,4805,7135,4030,2989,3814,6431,4961,7202,8619,13566,8991,48255,25389,22866,45659,1235,193,277,878,49832,10849,20155.0,21020.0
473,"Knox County, Indiana",18817,1141,1422,722,1043,1258,793,709,18,83,18083,3918,3244,4768,2745,2817,3127,4752,3749,6735,6371,9520,6494,37065,18817,18248,34881,1036,336,202,752,47380,6717,15516.0,16027.0
474,"Madison County, Indiana",64666,3801,3898,2618,3567,3589,4012,2425,18,95,18095,10031,12557,17273,10169,9372,11469,17298,13057,19403,24026,34571,23226,129455,64666,64789,113506,10255,663,1209,5301,49522,26136,53909.0,51711.0
475,"Pike County, Indiana",6176,330,336,252,366,449,342,279,18,125,18125,794,1036,1821,1130,722,1006,1731,1307,1516,2042,3552,2437,12378,6176,6202,11979,109,111,59,115,50194,2507,5977.0,6220.0
476,"Pulaski County, Indiana",6330,327,394,251,322,453,374,278,18,131,18131,893,1119,1724,1150,776,1030,1772,1224,1669,2149,3496,2374,12559,6330,6229,11940,24,81,185,378,49580,2752,5459.0,5813.0
477,"Steuben County, Indiana",17548,988,922,643,893,923,915,671,18,151,18151,3096,2695,4911,3179,2356,2635,4945,3567,5452,5330,9856,6746,34453,17548,16905,33232,114,152,114,1220,58279,7260,14566.0,16175.0
478,"Laramie County, Wyoming",49857,3181,3463,1907,2993,3235,3091,1745,56,21,56021,8909,10030,12170,7057,7508,9185,12489,8217,16417,19215,24659,15274,98320,49857,48463,88215,2104,1169,2089,14379,66910,19113,40969.0,44865.0
479,"Teton County, Wyoming",12325,709,963,259,452,573,597,241,56,39,56039,1971,3118,3049,1612,1748,2889,2799,1656,3719,6007,5848,3268,23280,12325,10955,20785,290,291,1656,3498,84678,6446,12627.0,14677.0
480,"San Jacinto County, Texas",13797,706,765,470,749,799,1167,518,48,407,48407,1711,2202,3893,2986,1744,2246,3919,3241,3455,4448,7812,6227,28180,13797,14383,24134,2598,9,521,3693,41614,5109,10343.0,12628.0
481,"Upshur County, Texas",20139,1095,1519,890,1275,1453,1241,824,48,459,48459,2873,3371,5547,3327,2674,3603,5786,4023,5547,6974,11333,7350,41018,20139,20879,35529,3370,128,980,3524,52162,6885,16013.0,18850.0
482,"Waller County, Texas",25844,1903,2065,1003,1480,1696,1920,930,48,473,48473,6822,4176,5514,2827,7051,4044,5681,3186,13873,8220,11195,6013,51832,25844,25988,30096,12911,530,7016,15581,59642,6623,16784.0,22617.0
483,"Wilson County, Texas",24716,1530,1724,1208,1412,1507,1788,1179,48,493,48493,3529,4422,6916,3686,3205,4457,7038,3871,6734,8879,13954,7557,49173,24716,24457,45548,690,173,921,19513,76692,10528,19432.0,25006.0
484,"Hockley County, Texas",11502,834,802,565,716,771,921,505,48,219,48219,2236,2065,2569,1515,2035,2096,2745,1773,4271,4161,5314,3288,23064,11502,11562,20383,746,83,1148,11023,48248,3315,7311.0,8091.0
485,"Midland County, Texas",85041,7665,6717,3614,7089,6821,5917,3262,48,329,48329,15842,19549,17462,7569,14728,17364,18259,9686,30570,36913,35721,17255,168167,85041,83126,138180,11200,3356,10213,75224,79421,27564,49212.0,58752.0
486,"Llano County, Texas",10356,392,472,325,429,408,312,199,48,299,48299,1025,1195,2683,3641,1033,1132,3163,4015,2058,2327,5846,7656,21047,10356,10691,19456,143,65,484,2187,53411,3575,10447.0,13278.0
487,"Fannin County, Texas",18246,852,877,634,888,914,1159,687,48,147,48147,2981,3552,4970,3073,2078,2780,4460,3325,5059,6332,9430,6398,34537,18246,16291,30288,1953,232,642,3900,54648,6486,12044.0,14969.0
488,"Brazos County, Texas",112629,6941,5767,3554,6741,6444,5872,3616,48,41,48041,41418,20428,18754,8857,37258,19751,19741,10929,78676,40179,38495,19786,222981,112629,110352,171189,23807,13711,6720,56995,49181,37648,67211.0,84753.0
489,"Gaines County, Texas",10556,1161,938,661,1111,1023,1015,473,48,165,48165,1788,1999,2099,836,1608,1929,2007,984,3396,3928,4106,1820,20706,10556,10150,19578,522,102,378,8591,63054,2057,4620.0,5960.0
490,"Gray County, Texas",11819,855,905,385,754,843,747,549,48,179,48179,1752,2761,2878,1586,1452,1880,2406,1960,3204,4641,5284,3546,22410,11819,10591,19089,1007,150,1212,6498,47952,3597,7405.0,7745.0
491,"Jack County, Texas",5053,324,251,153,154,198,322,187,48,237,48237,1104,1051,1179,703,436,702,993,807,1540,1753,2172,1510,8852,5053,3799,8227,443,9,79,1494,52045,1668,3350.0,3779.0
492,"Bosque County, Texas",9013,492,441,362,487,459,581,333,48,35,48035,1082,1328,2403,2160,1105,1398,2576,2344,2187,2726,4979,4504,18296,9013,9283,17318,301,100,137,3356,52148,3627,7838.0,9094.0
493,"Bexar County, Texas",964179,71001,70599,42211,68116,68423,69125,40909,48,29,48029,187575,208539,212345,99926,175044,206687,228909,131451,362619,415226,441254,231377,1952843,964179,988664,1549704,149706,55742,115334,1175975,57157,342699,589645.0,757667.0
494,"Baylor County, Texas",1746,86,54,54,67,195,37,47,48,23,48023,211,269,450,416,252,269,513,451,463,538,963,867,3577,1746,1831,3291,123,0,92,305,40739,702,1499.0,1680.0
495,"Denton County, Texas",410114,27168,29148,18627,25887,29177,29260,17900,48,121,48121,68387,93750,104676,36612,70480,97693,107786,45525,138867,191443,212462,82137,833822,410114,423708,619566,81758,72510,25101,160933,86913,190537,298645.0,416610.0
496,"Galveston County, Texas",163877,10900,12008,7157,10373,10541,11913,6909,48,167,48167,25666,32344,43300,21039,24986,33683,45208,25395,50652,66027,88508,46434,332885,163877,169008,262336,41809,10946,6797,82003,73330,63359,122903.0,153843.0
497,"Roberts County, Texas",387,19,16,10,9,29,32,50,48,393,48393,40,64,91,95,36,58,93,111,76,122,184,206,805,387,418,782,0,0,0,107,68750,143,554.0,550.0
498,"Uvalde County, Texas",13185,1024,750,627,952,928,1084,669,48,463,48463,2413,2367,2715,2026,2249,2410,2975,2468,4662,4777,5690,4494,26920,13185,13735,25125,170,266,1043,19306,41679,3938,8964.0,10323.0
499,"Bowie County, Texas",46960,3168,2961,2032,2819,2739,3402,1727,48,37,48037,7903,9516,11459,6621,6567,8746,11766,8647,14470,18262,23225,15268,93373,46960,46413,64586,22879,983,1383,7098,50164,16214,34602.0,38194.0
500,"Kent County, Texas",295,13,38,10,9,25,19,26,48,263,48263,21,43,80,71,13,68,81,111,34,111,161,182,647,295,352,592,6,0,33,91,44688,129,434.0,462.0
501,"Somervell County, Texas",4448,290,329,93,158,93,444,255,48,425,48425,523,940,1133,805,537,846,1260,819,1060,1786,2393,1624,8860,4448,4412,7865,105,24,671,1646,60632,1927,3897.0,4940.0
502,"Hardin County, Texas",27374,1846,1976,1138,1885,2270,1914,1242,48,199,48199,4032,5299,7161,4164,3909,5473,7510,5188,7941,10772,14671,9352,56765,27374,29391,51841,3279,351,356,3230,60339,10858,22780.0,27555.0
503,"Leon County, Texas",8569,548,479,340,499,596,499,306,48,289,48289,1121,1366,2074,2011,1005,1358,2229,2164,2126,2724,4303,4175,17225,8569,8656,15331,1173,138,269,2509,43045,2996,7439.0,8672.0
504,"Newton County, Texas",7130,283,425,315,349,355,447,234,48,351,48351,1191,1188,2032,1300,906,1049,1944,1500,2097,2237,3976,2800,13914,7130,6784,10517,2823,77,39,504,40101,2195,5534.0,6096.0
505,"Reeves County, Texas",8744,410,599,351,490,368,563,250,48,389,48389,1981,2332,1825,842,833,1501,1624,1119,2814,3833,3449,1961,15492,8744,6748,12014,446,204,2682,11571,53311,2278,3184.0,3683.0
506,"Travis County, Texas",619629,40185,38436,21304,38093,36373,36739,20753,48,453,48453,122262,164354,142441,52555,117397,151750,142143,63928,239659,316104,284584,116483,1226805,619629,607176,889046,101955,82257,101061,414745,75887,297378,468720.0,605034.0
507,"Collingsworth County, Texas",1493,99,135,71,88,84,98,37,48,87,48087,192,274,392,198,183,268,412,306,375,542,804,504,2969,1493,1476,2283,273,0,258,854,39120,533,1156.0,1218.0
508,"Erath County, Texas",20347,1423,1359,710,1152,1252,1098,689,48,143,48143,5555,3246,4301,2685,6371,3173,4569,3190,11926,6419,8870,5875,41841,20347,21494,37186,799,388,1928,8821,52742,6843,13893.0,16837.0
509,"Motley County, Texas",675,21,69,34,30,67,54,20,48,345,48345,117,71,126,213,59,80,87,180,176,151,213,393,1252,675,577,1096,19,0,98,246,43859,199,615.0,652.0
510,"Coleman County, Texas",4308,260,238,149,204,277,183,181,48,83,48083,451,605,1282,1030,446,618,1088,1029,897,1223,2370,2059,8334,4308,4026,7300,134,42,451,1460,46743,1577,3643.0,4128.0
511,"Medina County, Texas",25816,1495,1529,1095,1435,1541,1747,1026,48,325,48325,4830,4558,6705,3875,3236,4115,6745,4396,8066,8673,13450,8271,50057,25816,24241,45440,1331,359,1634,26016,62599,8599,17246.0,22568.0
512,"Henderson County, Texas",39485,2297,2073,1608,2191,2306,2498,1601,48,213,48213,5635,6263,10503,8216,5281,6748,11358,9602,10916,13011,21861,17818,81070,39485,41585,72540,5404,525,730,10347,47355,14300,30045.0,36197.0
513,"Lamar County, Texas",23770,1695,1821,984,1621,1404,1779,1082,48,277,48277,3657,4019,6062,4093,3642,4337,6686,5290,7299,8356,12748,9383,49611,23770,25841,40350,6358,384,250,3902,45117,8565,18611.0,21338.0
514,"Kimble County, Texas",2168,195,78,172,85,94,117,57,48,267,48267,191,264,553,581,210,303,653,686,401,567,1206,1267,4373,2168,2205,4027,48,0,161,953,43328,850,1952.0,2292.0
515,"Washington County, Texas",17282,1056,974,678,1056,811,1094,694,48,477,48477,2850,2660,4430,3296,2867,2773,4506,4080,5717,5433,8936,7376,35163,17282,17881,27569,5805,582,438,5646,54971,6668,14828.0,17410.0
516,"Stephens County, Texas",4858,98,381,257,383,253,316,87,48,429,48429,936,839,1187,816,564,745,1149,1009,1500,1584,2336,1825,9364,4858,4506,8441,265,31,263,2223,46232,1236,3461.0,3799.0
517,"Andrews County, Texas",9174,799,875,440,752,724,832,485,48,3,48003,1598,1923,1966,792,1364,1753,1934,1018,2962,3676,3900,1810,18036,9174,8862,16108,122,65,1094,10151,76158,2749,4943.0,5856.0
518,"Gonzales County, Texas",10540,809,814,507,706,636,844,439,48,177,48177,1637,1722,2614,1586,1396,1820,2543,1807,3033,3542,5157,3393,20731,10540,10191,13784,1382,76,5093,10518,53577,3130,6334.0,7534.0
519,"Lynn County, Texas",3011,196,205,157,192,311,177,87,48,305,48305,434,585,723,458,342,504,677,529,776,1089,1400,987,5830,3011,2819,5199,65,46,223,2753,43382,847,2009.0,2293.0
520,"Zapata County, Texas",7095,714,954,361,614,752,540,367,48,505,48505,1221,1219,1236,896,1182,1327,1348,1079,2403,2546,2584,1975,14304,7095,7209,13405,0,112,726,13501,33952,2085,3142.0,3867.0
521,"Hood County, Texas",28416,1557,1755,1165,1615,1731,1662,1051,48,221,48221,3527,4218,7730,6710,3432,4545,8179,7687,6959,8763,15909,14397,58318,28416,29902,55523,466,411,481,7232,64041,11050,26262.0,32580.0
522,"King County, Texas",117,10,0,0,4,9,14,8,48,269,48269,3,12,52,15,23,14,38,10,26,26,90,25,237,117,120,234,0,0,3,78,52083,54,159.0,159.0
523,"Cherokee County, Texas",26587,1891,2049,1177,1838,1719,1788,1098,48,73,48073,4387,4636,6623,4063,3615,4457,6193,4823,8002,9093,12816,8886,52118,26587,25531,42374,7092,241,1009,12058,48186,7998,16790.0,19457.0
524,"Delta County, Texas",2488,148,185,109,149,193,242,108,48,119,48119,336,410,721,491,359,351,794,565,695,761,1515,1056,5249,2488,2761,4594,461,28,57,408,51038,1043,2281.0,2587.0
525,"Jones County, Texas",12527,430,361,327,444,454,520,281,48,253,48253,2757,3632,2900,1455,916,1185,2035,1581,3673,4817,4935,3036,19943,12527,7416,13992,2889,77,1719,5494,50344,3353,5960.0,6691.0
526,"Windham County, Connecticut",57727,2930,3341,2281,2810,3159,3196,2126,9,15,09015,9743,10634,16956,8344,9331,10579,17270,10368,19074,21213,34226,18712,116566,57727,58839,104021,2649,1611,3254,13754,66550,24672,50823.0,57151.0
527,"New London County, Connecticut",134037,6886,6513,5038,6412,6760,7596,4746,9,11,09011,25279,23278,37233,21360,19721,23172,38885,26061,45000,46450,76118,47421,267390,134037,133353,215896,15537,11091,8861,28213,73490,58976,123528.0,139493.0
528,"Middlesex County, Connecticut",79641,3560,4090,3148,3176,3443,4591,2955,9,7,09007,12055,13421,24812,14205,11389,13820,26171,17867,23444,27241,50983,32072,163053,79641,83412,143486,9119,5017,1742,10095,85898,41699,88624.0,98549.0
529,"Tolland County, Connecticut",75601,3215,3509,2679,2928,3396,3918,2713,9,13,09013,18697,12251,20358,10675,17956,11271,20815,12465,36653,23522,41173,23140,151063,75601,75462,132820,4806,7371,2396,8332,87069,36464,77424.0,80542.0
530,"Fairfield County, Connecticut",459636,26672,29572,20521,25460,28623,31352,19664,9,1,09001,70632,85108,131117,63376,67991,88134,139821,83245,138623,173242,270938,146621,943926,459636,484290,688856,109186,50339,63191,185996,95645,229609,421209.0,460639.0
531,"Washington County, Florida",13409,559,603,411,616,761,693,379,12,133,12133,2334,3097,3633,2002,1436,1922,3282,2266,3770,5019,6915,4268,24764,13409,11355,19725,3764,167,236,915,37022,4382,11156.0,12325.0
532,"Duval County, Florida",454084,32440,29603,16534,30935,28651,28294,16179,12,31,12031,83587,94136,113247,55121,81878,97688,125155,73322,165465,191824,238402,128443,936186,454084,482102,559532,277195,43297,19352,91153,55807,178506,432695.0,493118.0
533,"Bradford County, Florida",15021,720,1147,388,587,579,977,417,12,7,12007,2781,3408,3853,2121,1628,2114,3248,2746,4409,5522,7101,4867,27317,15021,12296,21101,5544,166,98,1137,45921,4585,12098.0,13650.0
534,"Brevard County, Florida",286412,14021,13580,10129,13295,13615,15821,9658,12,9,12009,40582,45351,82409,62706,36102,46803,89346,74455,76684,92154,171755,137161,585507,286412,299095,482985,56493,13854,9013,60266,56775,122279,314752.0,361306.0
535,"Clay County, Florida",104304,5994,7361,4903,5673,6645,7120,4703,12,19,12019,15732,19680,28316,15012,14564,20866,29999,17531,30296,40546,58315,32543,211405,104304,107101,167504,23291,5896,4823,21002,65740,40112,106483.0,124522.0
536,"Lafayette County, Florida",5125,179,479,206,282,212,234,223,12,67,12067,1037,1289,1319,532,498,533,874,656,1535,1822,2193,1188,8637,5125,3512,6931,1394,0,7,1360,50165,1379,3392.0,3657.0
537,"Lake County, Florida",167643,8709,8736,6147,8305,8684,9848,5664,12,69,12069,21041,27276,42625,42292,20813,28645,46742,49523,41854,55921,89367,91815,345867,167643,178224,285337,37766,7000,6464,53938,54513,68433,170462.0,211314.0
538,"Nassau County, Florida",41211,2286,2464,1671,1919,1963,2560,1363,12,89,12089,5226,7106,11636,8489,5066,7223,12398,9395,10292,14329,24034,17884,83098,41211,41887,75070,5031,851,766,3579,69943,19041,46607.0,58828.0
539,"Pinellas County, Florida",463198,21761,21961,14329,20667,21608,21430,13797,12,103,12103,62328,79405,136263,104441,62216,82422,148954,130374,124544,161827,285217,234815,964666,463198,501468,785739,98942,32679,13396,93587,54090,215137,492403.0,560668.0
540,"Polk County, Florida",336279,20463,20933,13633,19524,20404,21673,12967,12,105,12105,52329,61021,81100,63538,51672,62555,86341,74803,104001,123576,167441,138341,686218,336279,349939,528843,104676,12244,20845,154628,50584,121738,284314.0,343423.0
541,"St. Lucie County, Florida",152727,8366,8560,5817,7899,7716,9473,5343,12,111,12111,21176,25257,39406,34635,20105,26713,43246,39725,41281,51970,82652,74360,312947,152727,160220,228616,63087,6383,5796,59355,52322,58960,140847.0,172131.0
542,"Glades County, Florida",7509,221,213,200,207,313,426,86,12,43,12043,1083,1543,1917,1918,852,800,1603,1720,1935,2343,3520,3638,13516,7509,6007,10780,1819,108,117,2873,40977,2232,4353.0,5201.0
543,"Hendry County, Florida",21600,1519,1523,1097,1484,1184,1745,740,12,51,12051,3752,4309,5033,2677,3089,3480,4742,2668,6841,7789,9775,5345,40732,21600,19132,32023,4688,355,1584,21888,40820,5179,11115.0,12944.0
544,"Indian River County, Florida",73951,3503,3827,2430,2934,3436,3543,2318,12,61,12061,8999,9809,19314,22765,8136,10648,22103,26920,17135,20457,41417,49685,153989,73951,80038,133103,13633,2037,1548,19063,54740,33145,80009.0,97619.0
545,"Jackson County, Florida",26318,1228,1196,854,1162,1107,1234,806,12,63,12063,4408,6027,7146,4106,2808,3674,5708,5128,7216,9701,12854,9234,47945,26318,21627,33057,12859,156,442,2328,39872,7727,21041.0,22415.0
546,"St. Johns County, Florida",119055,6164,7341,5120,6152,7394,7983,4829,12,109,12109,14535,21478,33602,22383,14304,22778,36325,25854,28839,44256,69927,48237,244674,119055,125619,216331,13224,6595,1419,17012,82252,57077,136514.0,176942.0
547,"Seminole County, Florida",223000,12543,13711,9036,11907,14276,12942,8989,12,117,12117,37104,46877,59287,30220,35994,48823,65580,39891,73098,95700,124867,70111,461402,223000,238402,349813,55186,20895,19707,98697,66768,102056,224896.0,260996.0
548,"Bay County, Florida",90531,5679,5231,3237,5493,5400,5273,3027,12,5,12005,14893,17536,24138,14208,13231,16996,25370,16840,28124,34532,49508,31048,182161,90531,91630,147657,20057,4269,2321,11815,54316,33566,87453.0,93025.0
549,"Flagler County, Florida",52399,1867,2622,1793,2388,2577,2854,1815,12,35,12035,6023,7564,13919,15695,5736,8270,16535,17227,11759,15834,30454,32922,109801,52399,57402,90342,11010,2874,2752,11448,54514,24016,57503.0,71773.0
550,"Gulf County, Florida",9109,394,402,251,328,379,289,174,12,45,12045,1614,2010,2551,1566,705,934,2003,1655,2319,2944,4554,3221,15576,9109,6467,12384,2673,85,102,687,47712,3087,7293.0,8170.0
551,"Liberty County, Florida",4973,195,233,176,118,163,253,119,12,77,12077,1081,1051,1476,642,477,675,929,638,1558,1726,2405,1280,8345,4973,3372,6682,1320,20,88,392,38015,1710,3296.0,3562.0
552,"Osceola County, Florida",173562,11542,11411,7960,10813,11730,11933,7650,12,97,12097,29921,37812,40886,20401,28671,38312,44067,25217,58592,76124,84953,45618,351955,173562,178393,256320,40336,9662,30282,190439,52279,63481,140206.0,172781.0
553,"Walton County, Florida",34533,2060,1679,1246,1974,1688,2170,1007,12,131,12131,4486,6858,9721,6374,3782,5876,10296,6936,8268,12734,20017,13310,68262,34533,33729,59228,3156,705,2141,4252,58093,14432,33637.0,43679.0
554,"Gadsden County, Florida",21790,1314,1364,808,1390,1366,1464,844,12,39,12039,3321,3957,6070,3463,3395,4688,6514,4494,6716,8645,12584,7957,45945,21790,24155,18202,25786,81,1326,4778,41401,6176,22113.0,23783.0
555,"Jefferson County, Florida",7432,281,413,138,323,281,377,214,12,65,12065,1002,1660,2141,1517,719,946,2137,1732,1721,2606,4278,3249,14161,7432,6729,8894,4894,39,88,584,47240,2770,7645.0,8459.0
556,"Marion County, Florida",169652,8979,8947,5781,8664,8399,9629,5586,12,83,12083,22176,25282,41601,46888,21691,27521,48034,54350,43867,52803,89635,101238,353526,169652,183874,289561,45754,5088,3779,46675,45371,70044,174700.0,204577.0
557,"Hardee County, Florida",14696,944,968,759,813,1025,853,485,12,49,12049,2729,2798,3198,2036,1815,2201,2994,2249,4544,4999,6192,4285,27131,14696,12435,21824,2051,234,2664,11828,38682,4889,7583.0,8484.0
558,"Okeechobee County, Florida",22205,1332,1153,1046,1140,1276,1115,544,12,93,12093,3436,4270,5698,3994,2578,3134,5011,4141,6014,7404,10709,8135,41144,22205,18939,35138,3414,395,1062,10497,41760,7337,13653.0,15964.0
559,"Orange County, Florida",662036,42530,41752,25547,40468,40728,41190,25457,12,95,12095,131341,148250,159915,68653,132623,150246,168499,88499,263964,298496,328414,157152,1349746,662036,687710,857963,282677,69700,86582,427125,58254,271562,546275.0,648405.0
560,"Gilchrist County, Florida",9415,507,368,605,381,396,570,349,12,41,12041,1933,1409,2384,1648,993,1412,2448,1989,2926,2821,4832,3637,17953,9415,8538,16382,1052,40,71,1049,43640,3683,8420.0,9680.0
561,"Suwannee County, Florida",22633,1145,1325,839,1040,1699,1415,651,12,121,12121,3109,4433,6124,4201,2707,3274,5792,4835,5816,7707,11916,9036,44046,22633,21413,36431,5683,55,441,4103,47839,8152,18694.0,21054.0
562,"Alachua County, Florida",128220,7118,6986,3770,6980,6581,6235,3721,12,1,12001,38494,23298,26157,16046,40692,23377,29370,20267,79186,46675,55527,36313,265443,128220,137223,182813,53278,16125,2931,26242,49689,54558,128571.0,142784.0
563,"Calhoun County, Florida",7917,308,425,224,328,400,354,326,12,13,12013,1209,1826,2143,1245,758,1138,1631,1510,1967,2964,3774,2755,14362,7917,6445,11553,1904,16,320,826,38568,2643,6081.0,6529.0
564,"Charlotte County, Florida",88465,2920,3205,2129,2493,3010,2902,2224,12,15,12015,8951,10015,23542,34370,7672,9897,27039,37365,16623,19912,50581,71735,181067,88465,92602,162847,10113,2342,1795,13189,51499,40740,96374.0,116481.0
565,"Dixie County, Florida",9289,375,558,281,359,422,353,222,12,29,12029,1229,1799,2726,1889,767,1154,2139,1884,1996,2953,4865,3773,16589,9289,7300,14333,1474,38,254,674,39828,3666,7202.0,8170.0
566,"Martin County, Florida",78707,3330,3460,2574,3123,2995,4276,2374,12,85,12085,9445,11414,21811,22530,7976,10372,23098,26144,17421,21786,44909,48674,159065,78707,80358,140110,9006,2226,3956,21667,61133,34807,85792.0,98887.0
567,"Sarasota County, Florida",200053,7612,8041,5852,7325,8376,8147,5520,12,115,12115,21517,25808,52414,69300,20764,26852,60550,81909,42281,52660,112964,151209,419496,200053,219443,381414,19002,7129,3669,38526,62236,102348,229063.0,270656.0
568,"Manatee County, Florida",185822,9397,9737,6586,8980,10086,9853,6073,12,81,12081,23749,28999,48628,48103,22819,30178,54828,55574,46568,59177,103456,103677,384213,185822,198391,328110,33462,7975,6359,63038,59009,82108,178958.0,217125.0
569,"Citrus County, Florida",70474,2689,2960,2007,2591,2499,3355,1929,12,17,12017,7467,8413,18272,25151,6665,8725,21421,27510,14132,17138,39693,52661,145169,70474,74695,134668,4288,2567,798,8263,44237,30796,79700.0,93223.0
570,"Baker County, Florida",14701,925,853,624,861,940,859,594,12,3,12003,2463,3039,3945,1775,2102,2342,3714,2098,4565,5381,7659,3873,28211,14701,13510,23279,3824,173,245,721,63275,4661,12634.0,14082.0
571,"Santa Rosa County, Florida",89306,5090,5317,3616,4828,4628,5953,3342,12,113,12113,14465,18189,24067,12736,11331,16370,24124,14873,25796,34559,48191,27609,174755,89306,85449,149250,10858,3423,2692,9730,67949,31453,87745.0,106782.0
572,"Leon County, Florida",137486,7748,7308,4699,7305,7465,7253,4528,12,73,12073,41028,23684,28759,16351,46021,25834,32849,21029,87049,49518,61608,37380,289770,137486,152284,177974,89536,10183,3301,18570,53106,59582,152132.0,162650.0
573,"Broward County, Florida",938043,57253,55878,35810,54981,53489,58441,35082,12,11,12011,143852,189537,258303,138164,140162,197852,272258,175897,284014,387389,530561,314061,1926205,938043,988162,1170083,551097,68988,65968,574289,59547,391710,831951.0,956076.0
574,"Monroe County, Florida",39491,1738,1502,932,1751,1290,1675,892,12,87,12087,5103,7276,12422,8843,4528,6580,11645,7946,9631,13856,24067,16789,75798,39491,36307,66728,5545,1058,1322,18439,70033,17656,42478.0,48074.0
575,"Hernando County, Florida",89454,4251,4605,3274,4208,4318,5399,3163,12,53,12053,11210,13656,23519,23742,10995,14477,26836,27463,22205,28133,50355,51205,186313,89454,96859,165227,9946,2283,3241,25178,48812,36071,93796.0,109176.0
576,"Hillsborough County, Florida",695072,45162,45260,27541,42810,43223,43460,26261,12,57,12057,119859,147247,176532,87528,121011,152362,187426,110653,240870,299609,363958,198181,1422278,695072,727206,1002119,239119,57655,65024,407736,58884,294604,597660.0,711103.0
577,"Taylor County, Florida",12254,505,831,344,501,396,821,319,12,123,12123,2202,2669,3089,2010,980,1708,2597,2294,3182,4377,5686,4304,21870,12254,9616,16678,4397,167,379,1410,40306,4015,9290.0,10101.0
578,"Wakulla County, Florida",17541,777,791,810,733,1117,876,643,12,129,12129,2468,4119,5240,2221,1611,2995,4311,2494,4079,7114,9551,4715,32321,17541,14780,26579,4874,167,328,1205,61410,5855,15351.0,18435.0
579,"McDuffie County, Georgia",9827,578,912,491,839,685,825,531,13,189,13189,1528,1695,2539,1524,1605,1913,3044,2186,3133,3608,5583,3710,21455,9827,11628,11585,8561,95,532,656,43468,2770,9268.0,10456.0
580,"Morgan County, Georgia",9065,609,614,314,437,559,548,443,13,211,13211,1317,1236,2687,1614,1165,1458,2835,1997,2482,2694,5522,3611,18507,9065,9442,13693,4347,13,121,595,66178,3214,9475.0,11705.0
581,"Heard County, Georgia",5796,372,376,246,284,339,374,260,13,149,13149,829,1004,1660,894,817,1073,1734,1059,1646,2077,3394,1953,11736,5796,5940,10198,1024,62,49,322,51358,2144,4223.0,5397.0
582,"Dougherty County, Georgia",41433,3060,3035,1750,2914,2599,3288,1810,13,95,13095,8064,7191,9495,5652,9008,8722,11863,8066,17072,15913,21358,13718,89703,41433,48270,23655,62417,867,1180,2565,39584,12130,34087.0,35266.0
583,"Fannin County, Georgia",12319,520,482,381,486,537,631,385,13,111,13111,1470,1658,3590,3398,1304,1795,4108,3830,2774,3453,7698,7228,25395,12319,13076,24517,63,94,198,600,47997,5350,11812.0,14825.0
584,"Houston County, Georgia",74436,5273,5711,3479,5031,5348,5755,3067,13,153,13153,12717,14887,18401,8245,12303,16659,20093,10815,25020,31546,38494,19060,153507,74436,79071,92662,47637,5065,1814,10026,61723,27068,60079.0,74947.0
585,"Laurens County, Georgia",22431,1627,1746,971,1496,1534,1632,963,13,175,13175,3377,3811,5739,3410,3581,4638,6365,4765,6958,8449,12104,8175,47405,22431,24974,27786,17687,538,943,1286,39120,7534,19530.0,22690.0
586,"Spalding County, Georgia",31624,2016,2706,1378,1942,2208,1960,1332,13,255,13255,4810,5727,8006,4978,4935,6131,8623,6551,9745,11858,16629,11529,65306,31624,33682,40803,22261,663,265,2978,47111,10920,25704.0,30161.0
587,"Telfair County, Georgia",9238,322,323,228,439,388,349,322,13,271,13271,1597,2659,2574,1222,805,1247,1658,1589,2402,3906,4232,2811,16035,9238,6797,8349,6615,17,867,1829,32405,2338,3796.0,4323.0
588,"Warren County, Indiana",4109,213,246,161,244,264,241,159,18,171,18171,497,707,1237,763,464,701,1160,895,961,1408,2397,1658,8237,4109,4128,8038,47,23,12,149,60553,1839,3930.0,4473.0
589,"Vermillion County, Indiana",7778,416,475,372,414,407,483,289,18,165,18165,1086,1350,2149,1354,964,1314,2222,1668,2050,2664,4371,3022,15539,7778,7761,15106,182,35,50,137,50243,3377,6939.0,7490.0
590,"Wells County, Indiana",13734,866,1005,601,844,904,994,618,18,179,18179,2027,2334,3682,2147,1754,2473,3813,2877,3781,4807,7495,5024,28011,13734,14277,26818,224,115,309,861,59237,5608,13185.0,14080.0
591,"Allen County, Indiana",182088,13577,13224,8181,12656,13574,12824,8141,18,3,18003,30333,34673,44868,23102,30516,35818,47109,29849,60849,70491,91977,52951,372575,182088,190487,294017,42798,14159,6882,27818,54857,66663,147137.0,168964.0
592,"Decatur County, Indiana",13182,879,889,603,849,888,817,624,18,31,18031,2045,2387,3528,1958,1852,2321,3603,2426,3897,4708,7131,4384,26562,13182,13380,25655,173,387,28,533,57949,5782,11127.0,12296.0
593,"Delaware County, Indiana",55549,2935,2927,2145,2836,2974,2628,1801,18,35,18035,14454,8489,13200,8330,15332,8858,13988,11054,29786,17347,27188,19384,115020,55549,59471,101663,8056,1644,385,2847,43512,21152,45123.0,48089.0
594,"Floyd County, Indiana",37319,2293,2076,1594,2233,2480,2478,1586,18,43,18043,5704,7099,10471,5200,5707,7558,11034,6925,11411,14657,21505,12125,77320,37319,40001,69863,3985,827,408,2535,64468,16091,37425.0,41742.0
595,"Jefferson County, Indiana",15332,1047,880,571,978,795,895,628,18,77,18077,2403,2788,4315,2488,2814,2951,4706,3102,5217,5739,9021,5590,32201,15332,16869,30433,679,286,338,901,52718,6908,13544.0,14726.0
596,"Jennings County, Indiana",13964,902,821,558,832,874,854,619,18,79,18079,2085,2432,4193,2015,1985,2302,3883,2397,4070,4734,8076,4412,27710,13964,13746,26750,395,63,265,683,54191,5829,11150.0,12272.0
597,"Johnson County, Indiana",75493,5086,5969,3398,4802,5186,5400,3279,18,81,18081,11734,15479,19055,9613,11467,15529,20023,12537,23201,31008,39078,22150,153716,75493,78223,139922,3801,5192,2037,5498,72440,32762,66500.0,77784.0
598,"Miami County, Indiana",19028,982,1222,730,895,944,1233,662,18,103,18103,3078,4056,5078,2873,2412,2856,4460,3325,5490,6912,9538,6198,35815,19028,16787,32391,1934,208,465,1151,50657,7363,13482.0,14493.0
599,"Morgan County, Indiana",34624,2063,2091,1530,1973,1929,2421,1508,18,109,18109,5068,5902,10290,5204,4629,6148,10523,6167,9697,12050,20813,11371,69922,34624,35298,67978,285,585,155,1102,64335,13839,31280.0,36214.0
600,"Gibson County, Indiana",16923,1083,1149,768,996,1119,986,657,18,51,18051,2430,3013,4652,2617,2340,2918,4547,3170,4770,5931,9199,5787,33656,16923,16733,31865,740,143,148,545,55462,6810,15484.0,16165.0
601,"Newton County, Indiana",6989,349,270,288,393,517,386,238,18,111,18111,999,1282,2038,1209,886,1229,1916,1438,1885,2511,3954,2647,13992,6989,7003,13617,33,0,223,898,55356,3018,5795.0,6606.0
602,"Orange County, Indiana",9805,628,515,443,543,583,615,405,18,117,18117,1356,1586,2852,1651,1210,1666,2672,2046,2566,3252,5524,3697,19545,9805,9740,18668,500,99,36,125,47917,3992,8192.0,8833.0
603,"St. Joseph County, Indiana",131381,8757,8612,5816,8623,8717,8633,5288,18,141,18141,23616,24273,32543,18179,24991,24648,34505,23430,48607,48921,67048,41609,270216,131381,138835,210451,34857,6585,7136,23501,52769,52132,110060.0,115547.0
604,"Kosciusko County, Indiana",39472,2585,2785,1671,2538,2573,2580,1604,18,85,18085,6253,7316,10280,5845,5975,6935,10376,6982,12228,14251,20656,12827,79035,39472,39563,74170,589,995,1288,6293,61366,15335,32084.0,35846.0
605,"Marshall County, Indiana",23189,1622,1918,1061,1325,1436,1733,1143,18,99,18099,3441,3847,6152,3607,3142,3925,6147,4421,6583,7772,12299,8028,46461,23189,23272,43518,358,217,1359,4688,52658,9383,18082.0,19934.0
606,"Switzerland County, Indiana",5533,340,463,307,310,458,219,206,18,155,18155,683,916,1503,938,626,964,1413,956,1309,1880,2916,1894,10685,5533,5152,10307,102,41,20,211,49383,2153,3699.0,4152.0
607,"Vanderburgh County, Indiana",87633,5547,5814,3340,5403,5309,5613,3039,18,163,18163,15326,16790,22947,12588,16183,16829,24104,17178,31509,33619,47051,29766,181291,87633,93658,154112,17307,2256,2209,4814,49708,36286,72507.0,77563.0
608,"Blackford County, Indiana",5965,327,437,257,310,353,386,197,18,9,18009,880,918,1704,1118,734,958,1704,1406,1614,1876,3408,2524,12013,5965,6048,11669,4,87,0,196,43505,2710,4839.0,5354.0
609,"Scott County, Indiana",11681,764,568,480,660,785,819,440,18,143,18143,1855,2053,3408,1751,1616,2142,3420,2196,3471,4195,6828,3947,23759,11681,12078,23171,48,117,38,541,48700,4968,9101.0,10176.0
610,"Monroe County, Indiana",72846,3253,3260,2095,3165,3204,2864,1988,18,105,18105,25974,12479,14404,8098,24992,11821,15216,10365,50966,24300,29620,18463,146461,72846,73615,126086,4469,9784,744,4998,49839,30906,58454.0,63020.0
611,"Elkhart County, Indiana",101223,7895,7726,4858,7580,7051,8555,4641,18,39,18039,16182,18697,24601,12846,15419,18683,25009,16397,31601,37380,49610,29243,204558,101223,103335,178541,11115,2147,5678,32583,57021,34287,65630.0,73225.0
612,"Crawford County, Indiana",5356,289,390,238,300,372,339,203,18,25,18025,708,883,1561,997,619,854,1498,1028,1327,1737,3059,2025,10569,5356,5213,10258,41,0,10,158,41662,2253,4593.0,4979.0
613,"Cass County, Indiana",19019,1217,1149,878,1120,954,1394,764,18,17,18017,2882,3432,5222,2902,2619,3214,5104,3692,5501,6646,10326,6594,37880,19019,18861,31859,441,527,3836,5817,49415,6896,14209.0,15185.0
614,"Marion County, Indiana",458696,35870,34485,18443,33766,32336,30800,18003,18,97,18097,85037,95493,108770,48981,90292,100974,119177,67825,175329,196467,227947,116806,951869,458696,493173,587672,266137,31377,31639,98928,48316,176401,362372.0,390106.0
615,"Wayne County, Indiana",32240,1951,2185,1412,1907,1796,2259,1185,18,177,18177,5036,5665,8763,5247,4884,5774,9077,7220,9920,11439,17840,12467,66342,32240,34102,59572,3378,741,472,1990,46516,12644,25579.0,27662.0
616,"Butler County, Iowa",7291,401,452,343,391,435,518,270,19,23,19023,820,1216,1976,1485,763,1221,1956,1783,1583,2437,3932,3268,14628,7291,7337,14262,153,31,10,202,57115,3143,7513.0,8081.0
617,"Fremont County, Iowa",3455,209,164,130,185,216,220,130,19,71,19071,393,582,1007,712,345,568,992,835,738,1150,1999,1547,6946,3455,3491,6614,55,0,155,193,56750,1362,3595.0,3855.0
618,"Hamilton County, Iowa",7376,485,452,280,433,379,645,276,19,79,19079,873,1355,2117,1331,898,1278,2019,1693,1771,2633,4136,3024,14997,7376,7621,14077,202,455,201,904,60910,3067,7694.0,8516.0
619,"Taylor County, Iowa",3133,188,253,125,154,182,209,100,19,173,19173,389,526,798,630,372,504,788,725,761,1030,1586,1355,6167,3133,3034,5833,1,63,157,475,50431,1153,3029.0,3237.0
620,"Union County, Iowa",6001,344,418,236,346,325,447,273,19,175,19175,895,1065,1525,1132,897,1109,1617,1343,1792,2174,3142,2475,12358,6001,6357,11949,62,180,26,369,49900,2236,5832.0,6163.0
621,"Worth County, Iowa",3755,219,232,144,193,197,227,151,19,195,19195,506,646,1102,708,512,553,1062,795,1018,1199,2164,1503,7445,3755,3690,7184,121,25,20,222,57130,1457,4257.0,4405.0
622,"Ringgold County, Iowa",2418,165,181,105,131,156,168,118,19,159,19159,272,385,614,522,271,384,648,670,543,769,1262,1192,4964,2418,2546,4761,4,49,99,125,55271,1090,2707.0,2709.0
623,"Adair County, Iowa",3505,213,221,128,173,209,225,137,19,1,19001,448,572,1020,690,384,592,984,876,832,1164,2004,1566,7085,3505,3580,6911,39,48,13,146,53363,1609,3811.0,4183.0
624,"Chickasaw County, Iowa",6090,369,471,244,354,390,399,230,19,37,19037,858,905,1842,1106,725,889,1635,1314,1583,1794,3477,2420,12026,6090,5936,11770,129,15,31,304,60034,2859,6435.0,6605.0
625,"Clarke County, Iowa",4588,347,239,187,327,332,280,162,19,39,19039,612,823,1208,745,594,774,1377,926,1206,1597,2585,1671,9360,4588,4772,8946,6,69,122,1337,54427,1905,4454.0,4666.0
626,"Dickinson County, Iowa",8519,413,533,318,379,386,449,269,19,59,19059,988,1398,2405,1975,949,1331,2446,2399,1937,2729,4851,4374,17127,8519,8608,16683,77,152,46,344,59969,4063,10354.0,11223.0
627,"Johnson County, Iowa",73612,4478,4219,2171,4366,4232,4009,2267,19,103,19103,21784,14746,14485,7652,22136,13669,15128,9158,43920,28415,29613,16810,148577,73612,74965,121408,10815,9271,3239,8345,62542,33557,76940.0,83533.0
628,"Keokuk County, Iowa",5180,315,379,229,303,310,281,194,19,107,19107,676,819,1444,1007,579,809,1345,1187,1255,1628,2789,2194,10188,5180,5008,9932,46,29,37,178,52881,2351,4985.0,5273.0
629,"Tama County, Iowa",8444,544,462,398,542,581,541,363,19,171,19171,1119,1335,2407,1514,1033,1361,2357,1810,2152,2696,4764,3324,17032,8444,8588,14952,157,78,225,1666,56037,3330,8752.0,9017.0
630,"Wapello County, Iowa",17401,1190,1087,668,1045,1003,1210,680,19,179,19179,2808,3166,4642,2736,2586,3130,4722,3364,5394,6296,9364,6100,35141,17401,17740,30687,1248,432,1794,3787,46246,6622,15149.0,15607.0
631,"Franklin County, Iowa",5055,268,399,192,336,341,282,173,19,69,19069,629,905,1354,956,656,767,1399,1153,1285,1672,2753,2109,10162,5055,5107,9669,25,0,427,1296,56419,2074,4968.0,5116.0
632,"Carroll County, Iowa",10005,691,760,474,615,723,621,394,19,27,19027,1284,1675,2710,1721,1270,1663,2711,2279,2554,3338,5421,4000,20281,10005,10276,19747,19,41,251,506,59212,4314,10544.0,11277.0
633,"Cedar County, Iowa",9179,483,678,400,439,621,620,397,19,31,19031,1108,1672,2583,1638,1061,1563,2662,1915,2169,3235,5245,3553,18457,9179,9278,17988,260,67,11,377,67795,4279,9541.0,10702.0
634,"Floyd County, Iowa",7757,463,540,316,403,513,568,288,19,67,19067,1106,1260,2063,1538,1042,1134,2191,1890,2148,2394,4254,3428,15786,7757,8029,14832,271,237,42,511,50406,3052,8060.0,8026.0
635,"Greene County, Iowa",4397,272,340,193,245,337,237,172,19,73,19073,566,709,1213,858,495,696,1233,1138,1061,1405,2446,1996,8950,4397,4553,8571,48,66,82,260,53050,1907,4821.0,5054.0
636,"Louisa County, Iowa",5728,340,337,296,293,199,445,209,19,115,19115,883,981,1523,959,737,956,1521,1090,1620,1937,3044,2049,11178,5728,5450,10097,126,377,382,1764,56673,2086,5008.0,5326.0
637,"Lyon County, Iowa",6012,462,522,284,407,532,352,257,19,119,19119,757,1108,1422,943,650,1033,1373,1160,1407,2141,2795,2103,11776,6012,5764,11383,10,30,120,312,64982,2417,6377.0,6846.0
638,"Union County, Georgia",11350,498,553,395,464,572,458,327,13,291,13291,1158,1576,3100,3534,1115,1556,3412,4034,2273,3132,6512,7568,23288,11350,11938,22580,173,72,31,771,50021,5160,12063.0,15592.0
639,"Bladen County, North Carolina",16030,1066,970,631,694,842,1176,627,37,17,37017,2184,2726,4402,3066,2164,2883,5029,3962,4348,5609,9431,7028,33407,16030,17377,19260,11594,50,1334,2499,36173,5205,15897.0,17009.0
640,"Carteret County, North Carolina",33874,1515,1798,1178,1402,1608,1749,1111,37,31,37031,4177,5547,9970,7779,3782,5539,11041,8964,7959,11086,21011,16743,69070,33874,35196,62094,3685,808,322,2966,57194,14522,37781.0,42446.0
641,"Bertie County, North Carolina",9689,289,495,356,536,509,423,251,37,15,37015,1731,1822,2688,1773,1181,1443,2877,2471,2912,3265,5565,4244,19380,9689,9691,6830,11933,151,156,413,35527,2663,9347.0,9680.0
642,"Martin County, North Carolina",10777,676,636,382,576,451,811,431,37,117,37117,1526,1528,3142,2162,1520,1837,3511,2935,3046,3365,6653,5097,22849,10777,12072,12460,9625,139,237,911,40090,3361,11964.0,12454.0
643,"Perquimans County, North Carolina",6533,272,329,260,327,367,372,158,37,143,37143,709,883,1954,1673,721,1061,1927,1964,1430,1944,3881,3637,13430,6533,6897,9904,3217,48,69,349,47162,2186,6708.0,7457.0
644,"Rockingham County, North Carolina",43801,2373,2561,1737,2361,2729,2449,1692,37,157,37157,6114,7355,13003,7904,5985,7816,14035,10209,12099,15171,27038,18113,91077,43801,47276,68702,16739,535,2480,5560,43579,14839,42278.0,47241.0
645,"Camden County, North Carolina",5587,256,435,283,229,197,410,117,37,29,37029,704,1033,1545,865,556,973,1500,982,1260,2006,3045,1847,10551,5587,4964,8718,1460,189,28,308,64572,1823,5006.0,5879.0
646,"Gaston County, North Carolina",105755,6735,6885,4471,6345,6914,6905,4317,37,71,37071,16473,19783,29443,14729,16160,21653,31234,19988,32633,41436,60677,34717,219271,105755,113516,168959,35824,3357,4590,15368,52835,38160,96431.0,113791.0
647,"Moore County, North Carolina",46871,2952,3119,1792,2698,2981,2768,1703,37,125,37125,5807,8383,11767,10297,5674,8682,13036,12881,11481,17065,24803,23178,97294,46871,50423,79973,12052,1239,1391,6544,59963,20864,48692.0,57771.0
648,"Stanly County, North Carolina",30696,1664,2208,1175,1655,1711,1896,1218,37,167,37167,4798,5385,8447,5157,4268,5212,8554,6378,9066,10597,17001,11535,61588,30696,30892,51502,7000,1104,559,2590,52623,10802,29917.0,33624.0
649,"Yancey County, North Carolina",8701,400,414,345,360,480,430,287,37,199,37199,1102,1370,2436,2049,1101,1370,2590,2441,2203,2740,5026,4490,17760,8701,9059,17083,119,50,157,917,42222,3600,9960.0,11282.0
650,"Chatham County, North Carolina",34010,1632,2069,1297,1829,1967,2302,1345,37,37,37037,3728,5657,9863,7616,3666,5986,10720,9513,7394,11643,20583,17129,71338,34010,37328,57718,8041,1068,2222,8707,67031,16610,39849.0,48308.0
651,"Johnston County, North Carolina",96841,6389,6774,4511,6076,6794,7352,4305,37,101,37101,13767,19501,26407,11189,13440,20471,27182,14409,27207,39972,53589,25598,196870,96841,100029,152007,31423,1242,5516,26781,59865,33673,85909.0,110246.0
652,"Person County, North Carolina",19087,1124,1162,847,1077,1038,1257,681,37,145,37145,2571,3371,5628,3235,2604,3426,5953,4222,5175,6797,11581,7457,39345,19087,20258,26592,10329,152,860,1691,51020,6450,19615.0,21737.0
653,"Ashe County, North Carolina",13207,598,774,499,544,436,903,443,37,9,37009,1601,2175,3876,3025,1433,2262,4026,3609,3034,4437,7902,6634,26863,13207,13656,25628,197,120,375,1330,40962,5323,13424.0,15691.0
654,"Lenoir County, North Carolina",27219,1728,1971,1206,1517,1870,1827,989,37,107,37107,3911,4552,7542,4636,3840,4670,8376,6448,7751,9222,15918,11084,56756,27219,29537,31205,22205,279,771,4414,39402,7320,26807.0,28177.0
655,"Onslow County, North Carolina",107985,8852,6553,2989,8520,6320,5596,2963,37,133,37133,43198,18346,14461,7749,20166,17076,16737,9706,63364,35422,31198,17455,195069,107985,87084,145758,27291,4210,2850,24543,50278,28496,57135.0,70117.0
656,"Rutherford County, North Carolina",32365,1869,2195,1486,1538,1810,1867,1308,37,161,37161,4337,5261,9258,6238,4353,5538,9975,7845,8690,10799,19233,14083,66599,32365,34234,57790,6355,282,550,2941,42608,11525,30307.0,34076.0
657,"Yadkin County, North Carolina",18625,1010,988,778,940,1081,1020,740,37,197,37197,2574,3103,5529,3230,2366,3088,5629,4113,4940,6191,11158,7343,37602,18625,18977,34639,1320,23,788,4163,44682,6277,17624.0,19794.0
658,"Burke County, North Carolina",44804,2053,2239,1900,2209,2200,2404,1462,37,23,37023,7615,7560,13082,7778,5934,7680,13350,9925,13549,15240,26432,17703,89968,44804,45164,75887,5477,3252,2773,5498,44557,15536,38920.0,44182.0
659,"Traill County, North Dakota",4085,244,224,159,219,301,184,171,38,97,38097,712,639,1133,695,538,619,1036,855,1250,1258,2169,1550,8008,4085,3923,7468,87,30,171,289,64453,1663,3933.0,4131.0
660,"Dickey County, North Dakota",2473,137,117,105,146,214,90,108,38,21,38021,351,428,645,451,348,367,635,557,699,795,1280,1008,4938,2473,2465,4769,65,8,3,167,65492,1007,2407.0,2408.0
661,"Ward County, North Dakota",35715,2668,2432,1012,2638,2467,2060,1032,38,101,38101,9464,7340,7078,3752,6754,6361,7121,4664,16218,13701,14199,8416,68812,35715,33097,59575,2653,1194,1025,4231,68871,14253,27412.0,28159.0
662,"Pembina County, North Dakota",3631,209,209,117,180,175,217,126,38,67,38067,421,597,1101,773,347,507,974,790,768,1104,2075,1563,6947,3631,3316,6551,23,37,2,241,64549,1365,3153.0,3303.0
663,"Hettinger County, North Dakota",1206,85,100,19,54,89,85,39,38,41,38041,129,181,338,307,187,236,339,312,316,417,677,619,2547,1206,1341,2343,10,0,43,79,60164,409,1296.0,1306.0
664,"Cass County, North Dakota",89658,6412,5680,2917,6106,5509,4964,2749,38,17,38017,21827,19561,18783,9200,20455,17460,18723,11351,42282,37021,37506,20551,176975,89658,87317,154002,9941,5120,1053,4769,64482,36325,80821.0,85906.0
665,"Emmons County, North Dakota",1684,83,92,44,98,99,91,38,38,29,38029,211,216,492,459,179,200,405,516,390,416,897,975,3310,1684,1626,3182,0,36,5,52,55902,687,1981.0,2006.0
666,"Richland County, North Dakota",8507,452,541,290,458,474,432,268,38,77,38077,1790,1360,2167,1335,1369,1287,1989,1470,3159,2647,4156,2805,16254,8507,7747,15120,112,62,151,512,61371,2861,7592.0,7757.0
667,"Adams County, North Dakota",1106,51,75,50,69,75,84,45,38,1,38001,152,168,321,225,102,197,295,338,254,365,616,563,2311,1106,1205,2172,48,58,0,39,56681,500,1218.0,1266.0
668,"Eddy County, North Dakota",1110,82,45,70,79,63,45,54,38,27,38027,110,201,279,266,156,168,319,307,266,369,598,573,2301,1110,1191,2097,0,0,0,29,54868,546,1231.0,1257.0
669,"Mercer County, North Dakota",4326,252,241,173,269,256,281,148,38,57,38057,557,754,1328,730,445,636,1281,820,1002,1390,2609,1550,8462,4326,4136,7869,73,38,208,249,82181,1542,4682.0,4668.0
670,"Ransom County, North Dakota",2633,161,191,108,126,128,165,98,38,73,38073,346,405,748,551,298,400,880,586,644,805,1628,1137,5314,2633,2681,5067,43,57,26,83,63903,1209,2359.0,2443.0
671,"Sioux County, North Dakota",2180,193,231,139,238,196,235,124,38,85,38085,394,358,482,167,368,384,472,176,762,742,954,343,4373,2180,2193,581,7,0,36,203,38939,433,1232.0,1185.0
672,"Golden Valley County, North Dakota",909,35,41,35,73,62,47,54,38,33,38033,109,160,280,186,115,129,260,196,224,289,540,382,1845,909,936,1711,0,0,0,58,58690,407,957.0,1024.0
673,"Towner County, North Dakota",1205,44,78,56,38,73,83,42,38,95,38095,175,186,339,244,47,142,336,258,222,328,675,502,2224,1205,1019,2052,17,4,0,88,52300,337,1157.0,1172.0
674,"Divide County, North Dakota",1111,15,110,41,69,61,48,109,38,23,38023,117,191,319,310,99,143,385,310,216,334,704,620,2335,1111,1224,2170,74,29,0,100,62865,416,1219.0,1197.0
675,"Sargent County, North Dakota",2059,90,133,63,112,98,104,63,38,81,38081,323,350,572,427,202,288,515,431,525,638,1087,858,3872,2059,1813,3647,96,11,18,120,63073,863,1997.0,2313.0
676,"Meigs County, Ohio",11549,620,728,502,539,538,821,484,39,105,39105,1524,1970,3410,2045,1385,2066,3292,2404,2909,4036,6702,4449,23078,11549,11529,22417,256,1,40,170,44899,4663,9985.0,10764.0
677,"Champaign County, Ohio",19360,1046,1022,909,1036,1108,1293,747,39,21,39021,2973,3285,5379,3186,2590,3274,5592,3845,5563,6559,10971,7031,38845,19360,19485,36711,712,199,111,617,60112,8637,18104.0,19369.0
678,"Greene County, Ohio",81988,4866,4775,3067,4501,4437,4781,2951,39,57,39057,15950,14750,21006,12585,15764,14505,22243,15332,31714,29255,43249,27917,166502,81988,84514,142871,11516,4892,1045,4735,68720,36442,81858.0,86616.0
679,"Lawrence County, Ohio",29384,1867,1694,1240,1581,1876,1773,1094,39,87,39087,4151,5315,8158,4862,4131,5496,8635,6214,8282,10811,16793,11076,60184,29384,30800,57458,1211,315,125,590,45118,13418,26607.0,27427.0
680,"Morgan County, Ohio",7320,350,455,330,361,425,430,262,39,115,39115,953,1236,2085,1431,876,1264,2096,1606,1829,2500,4181,3037,14640,7320,7320,13538,721,30,4,58,42341,3192,6443.0,6721.0
681,"Wyandot County, Ohio",10835,602,744,493,637,714,686,425,39,175,39175,1518,1893,3003,1810,1390,1934,3059,2320,2908,3827,6062,4130,22000,10835,11165,21372,36,183,154,660,55767,5340,10592.0,11122.0
682,"Erie County, Ohio",36673,2060,2213,1497,1950,1955,2215,1296,39,43,39043,5203,5758,10461,7369,5092,6255,10783,8561,10295,12013,21244,15930,74780,36673,38107,63928,6769,441,1015,3282,54226,15629,37578.0,39523.0
683,"Logan County, Ohio",22395,1444,1388,1002,1323,1337,1631,869,39,91,39091,3081,3850,6435,3589,3000,4014,6383,4364,6081,7864,12818,7953,45316,22395,22921,42862,808,372,156,740,56754,10318,21571.0,22985.0
684,"Summit County, Ohio",262595,15412,15753,10496,14991,14651,16313,10140,39,153,39153,42927,47730,72846,40942,41739,49077,78168,53660,84666,96807,151014,94602,541334,262595,278739,425243,78751,18430,1949,11598,57181,115669,257979.0,274768.0
685,"Lemhi County, Idaho",3987,182,246,112,210,249,135,146,16,59,16059,391,574,1085,1186,332,562,1115,1111,723,1136,2200,2297,7847,3987,3860,7430,3,0,59,268,39324,1556,4096.0,4738.0
686,"Payette County, Idaho",11544,787,890,498,734,949,836,493,16,75,16075,1572,1742,3054,2013,1511,2128,2918,2147,3083,3870,5972,4160,23260,11544,11716,20452,19,228,1534,4034,50579,3584,8704.0,11293.0
687,"Benewah County, Idaho",4620,243,305,197,286,255,287,178,16,9,16009,531,687,1303,1041,485,669,1371,987,1016,1356,2674,2028,9138,4620,4518,7916,6,29,14,332,47556,1709,4185.0,4972.0
688,"Bonner County, Idaho",21751,1019,1300,800,1106,1124,1267,820,16,17,16017,2371,3408,6328,5248,2138,3656,6636,5113,4509,7064,12964,10361,43611,21751,21860,41441,127,298,248,1354,50256,8266,20943.0,27352.0
689,"Clark County, Idaho",480,29,44,28,38,43,19,32,16,33,16033,95,84,82,86,43,86,123,49,138,170,205,135,913,480,433,825,7,0,39,443,46154,77,283.0,311.0
690,"Custer County, Idaho",2147,69,147,91,63,45,120,72,16,37,16037,241,313,516,705,222,238,599,663,463,551,1115,1368,4169,2147,2022,3807,5,0,45,175,40875,930,2414.0,2737.0
691,"Elmore County, Idaho",14059,1075,1202,515,1038,1104,676,446,16,39,16039,3285,2658,2933,1736,2362,2205,3109,1744,5647,4863,6042,3480,26743,14059,12684,22766,720,705,803,4564,46855,3435,8522.0,10205.0
692,"Fremont County, Idaho",6752,375,542,345,455,383,540,356,16,43,16043,1031,1259,1647,1117,792,1189,1456,1097,1823,2448,3103,2214,13020,6752,6268,12342,22,24,234,1629,58065,2331,5715.0,6719.0
693,"Madison County, Idaho",19881,2071,1255,841,1776,1339,1138,790,16,65,16065,8247,2483,2322,1193,7982,2375,2422,1397,16229,4858,4744,2590,39100,19881,19219,36286,65,610,842,2964,39160,4247,15688.0,17112.0
694,"Shoshone County, Idaho",6298,445,340,203,357,340,335,225,16,79,16079,799,1041,1803,1360,707,928,1963,1456,1506,1969,3766,2816,12609,6298,6311,11792,43,12,45,449,39386,2229,5120.0,6049.0
695,"Idaho County, Idaho",8629,412,420,318,359,409,506,251,16,49,16049,1127,1167,2338,2305,759,1069,2327,2102,1886,2236,4665,4407,16411,8629,7782,15319,23,66,98,558,41516,3566,8233.0,9602.0
696,"Teton County, Idaho",5972,359,499,199,368,467,334,239,16,81,16081,828,1430,1583,658,715,1257,1488,586,1543,2687,3071,1244,11426,5972,5454,10153,0,0,950,1928,74216,2343,4976.0,6347.0
697,"Power County, Idaho",3881,212,310,183,354,368,283,187,16,77,16077,355,878,884,633,464,693,871,570,819,1571,1755,1203,7671,3881,3790,6448,6,0,752,2616,48823,966,2758.0,3086.0
698,"Washington County, Idaho",4924,239,426,199,254,474,280,186,16,87,16087,572,803,1176,1222,533,766,1387,1253,1105,1569,2563,2475,10057,4924,5133,8834,19,37,738,1713,40992,1637,4455.0,5344.0
699,"Hancock County, Illinois",8975,497,606,365,469,449,543,321,17,67,17067,1172,1436,2538,1821,992,1414,2539,2281,2164,2850,5077,4102,17983,8975,9008,17512,109,66,19,269,52561,4092,9121.0,6565.0
700,"Madison County, Illinois",129045,7963,8233,5173,7344,7857,8154,4790,17,119,17119,19981,24321,35694,19049,20000,25225,36931,25430,39981,49546,72625,44479,264776,129045,135731,231440,22999,2793,1502,8626,60738,51864,130179.0,136141.0
701,"Grundy County, Illinois",25313,1680,2030,1213,1444,1726,1800,1146,17,63,17063,3585,5207,6646,3110,3563,5242,6661,3771,7148,10449,13307,6881,50666,25313,25353,47276,696,410,1308,5019,77350,10228,23237.0,26400.0
702,"Kankakee County, Illinois",54462,3325,3501,2418,3208,3566,3389,2253,17,91,17091,9761,9556,13950,8102,9551,9909,14393,9906,19312,19465,28343,18008,110637,54462,56175,88023,16858,933,2465,11504,58902,19795,47305.0,49729.0
703,"Mercer County, Illinois",7792,443,423,324,369,520,425,333,17,131,17131,969,1322,2236,1548,883,1282,2249,1736,1852,2604,4485,3284,15589,7792,7797,15128,98,65,48,380,59787,3467,8525.0,8750.0
704,"DuPage County, Illinois",456209,27977,29377,19576,26873,29543,28798,18826,17,43,17043,70679,90352,125249,61485,67620,89930,133358,77903,138299,180282,258607,139388,929060,456209,472851,713707,44755,110163,31669,132597,92809,235544,428769.0,467186.0
705,"Alexander County, Illinois",2991,231,192,69,186,189,279,100,17,3,17003,363,436,895,594,364,483,930,738,727,919,1825,1332,6260,2991,3269,3954,2094,0,22,82,36806,1047,2846.0,5631.0
706,"Menard County, Illinois",6031,372,417,239,305,436,371,226,17,129,17129,783,1051,1767,1074,701,1122,1800,1314,1484,2173,3567,2388,12306,6031,6275,11942,54,43,10,188,74684,2748,6515.0,6889.0
707,"LaSalle County, Illinois",55245,3175,3243,2237,2934,3256,3226,2208,17,99,17099,8378,10243,15526,9009,7144,9274,15190,11260,15522,19517,30716,20269,109737,55245,54492,101568,2937,792,2400,10658,58142,21525,49743.0,52053.0
708,"Cook County, Illinois",2522949,164555,158274,96236,157638,151817,158932,94469,17,31,17031,448051,555145,625541,311961,452759,560448,670054,429209,900810,1115593,1295595,741170,5198275,2522949,2675326,2946314,1217416,379444,500069,1314796,64660,1149438,2158615.0,1886299.0
709,"Macon County, Illinois",50585,3384,3365,1997,3119,3215,3136,2011,17,115,17115,7684,8642,13291,8929,8188,9406,14304,11564,15872,18048,27595,20493,105528,50585,54943,82154,15658,1064,548,2405,50480,19571,48060.0,48934.0
710,"Stephenson County, Illinois",21808,1284,1459,907,1255,1504,1258,806,17,177,17177,2933,3356,6228,4376,2714,3673,6492,5583,5647,7029,12720,9959,45093,21808,23285,38702,4334,382,175,1787,48805,8541,20343.0,21446.0
711,"Wayne County, Illinois",8110,498,450,331,528,480,549,299,17,191,17191,1076,1387,2184,1596,1027,1328,2184,1897,2103,2715,4368,3493,16402,8110,8292,15849,248,42,29,102,50251,3200,8261.0,8446.0
712,"Woodford County, Illinois",19355,1296,1383,874,1048,1286,1318,811,17,203,17203,2664,3364,5346,3044,2570,3397,5232,3683,5234,6761,10578,6727,38700,19355,19345,37472,254,200,103,707,72808,8896,19864.0,21079.0
713,"Franklin County, Illinois",19195,1234,1377,808,1041,1161,1079,745,17,55,17055,2567,3372,5184,3480,2626,3382,5355,4339,5193,6754,10539,7819,38923,19195,19728,37716,334,206,133,655,42769,7010,18711.0,18488.0
714,"McDonough County, Illinois",14845,673,738,400,688,591,824,412,17,109,17109,4532,2177,3151,2277,4453,2272,3437,2957,8985,4449,6588,5234,30479,14845,15634,27372,1442,653,159,844,44471,6077,13092.0,12290.0
715,"McHenry County, Illinois",153295,8638,10058,7404,8280,10178,10301,6982,17,111,17111,22309,28261,45445,19677,20668,28218,46345,23447,42977,56479,91790,43124,307714,153295,154419,284009,4481,8601,4315,40266,86799,66031,141750.0,156805.0
716,"Greeley County, Kansas",596,45,41,32,32,41,54,21,20,71,20071,55,110,150,120,55,98,165,123,110,208,315,243,1185,596,589,1042,0,0,118,293,54112,178,650.0,628.0
717,"Ellis County, Kansas",14329,822,753,511,904,1098,781,413,20,51,20051,3600,2519,3138,1947,3379,2430,3073,2368,6979,4949,6211,4315,28775,14329,14446,26783,312,324,194,1648,52883,6036,11947.0,13552.0
718,"Linn County, Kansas",4847,295,325,199,240,212,401,217,20,107,20107,539,813,1300,1069,522,826,1338,1068,1061,1639,2638,2137,9671,4847,4824,9258,80,50,13,261,48778,2134,4427.0,4911.0
719,"Seward County, Kansas",11410,1068,1198,499,948,986,1012,548,20,175,20175,2337,2199,2418,877,1998,1975,2250,1222,4335,4174,4668,2099,22349,11410,10939,13284,1039,592,6815,13685,49291,2345,5038.0,5099.0
720,"Johnson County, Kansas",290098,19255,20538,12852,18690,19779,20396,12437,20,91,20091,43598,62038,73527,36645,42127,62736,78719,46524,85725,124774,152246,83169,591506,290098,301408,508409,27703,30087,6385,45285,89087,148286,290090.0,338343.0
721,"Miami County, Kansas",16658,956,1129,806,947,1232,1223,667,20,121,20121,2161,2929,4779,2623,1870,2998,4751,3071,4031,5927,9530,5694,33417,16658,16759,31914,498,191,121,1078,71995,7249,15022.0,17655.0
722,"Woodson County, Kansas",1606,110,102,65,76,93,114,50,20,207,20207,144,293,449,367,157,244,413,404,301,537,862,771,3157,1606,1551,2930,14,0,8,12,39643,648,1443.0,1496.0
723,"Ness County, Kansas",1472,103,83,62,86,64,103,25,20,135,20135,158,185,444,346,137,204,404,381,295,389,848,727,2876,1472,1404,2684,15,10,116,294,56492,525,1454.0,1487.0
724,"Bourbon County, Kansas",7198,561,525,318,462,642,447,306,20,11,20011,1194,1164,1716,1237,961,1180,1809,1603,2155,2344,3525,2840,14608,7198,7410,13499,416,111,12,390,43917,2565,6093.0,6545.0
725,"Kiowa County, Kansas",1216,78,71,60,89,73,97,55,20,97,20097,190,180,326,246,227,154,306,288,417,334,632,534,2505,1216,1289,2351,21,19,25,160,53274,505,1079.0,1139.0
726,"Shawnee County, Kansas",85977,5613,6224,3739,5610,6122,5647,3457,20,177,20177,13020,15560,22175,13732,13119,16354,23998,17568,26139,31914,46173,31300,177852,85977,91875,146615,15142,2664,5046,21961,56762,37395,75406.0,84502.0
727,"Chautauqua County, Kansas",1747,98,105,83,94,72,103,36,20,19,20019,214,245,449,404,168,207,434,462,382,452,883,866,3323,1747,1576,2938,18,10,8,128,40298,721,1481.0,1634.0
728,"Reno County, Kansas",31578,1908,1842,1259,1633,2062,2009,1252,20,155,20155,5063,5866,8111,5244,4167,5174,8014,6876,9230,11040,16125,12120,62765,31578,31187,57332,1855,354,780,5951,49936,10316,24210.0,27148.0
729,"Doniphan County, Kansas",3921,193,245,137,183,265,174,119,20,43,20043,931,593,1006,668,689,586,966,781,1620,1179,1972,1449,7684,3921,3763,7108,459,5,12,214,49703,1415,3378.0,3682.0
730,"Haskell County, Kansas",2017,127,119,118,145,141,180,95,20,81,20081,314,374,453,285,277,382,496,285,591,756,949,570,4018,2017,2001,3461,1,5,449,1230,55064,461,1354.0,1383.0
731,"Scott County, Kansas",2555,209,268,126,130,117,232,74,20,171,20171,346,421,602,425,287,422,634,466,633,843,1236,891,4917,2555,2362,4634,0,61,145,766,65417,884,2202.0,2325.0
732,"Brown County, Kansas",4737,295,303,213,326,344,406,178,20,13,20013,606,799,1296,863,539,760,1322,1014,1145,1559,2618,1877,9626,4737,4889,8215,82,60,32,446,48333,1992,4036.0,4396.0
733,"Phillips County, Kansas",2631,148,184,99,159,213,126,110,20,147,20147,349,415,714,563,336,405,704,656,685,820,1418,1219,5340,2631,2709,5163,40,29,3,180,50093,1144,2664.0,3278.0
734,"Decatur County, Kansas",1424,87,84,29,75,79,57,60,20,39,20039,158,256,383,355,148,212,375,430,306,468,758,785,2860,1424,1436,2798,15,11,8,85,48125,673,1452.0,1458.0
735,"Garrard County, Kentucky",8506,532,590,323,457,504,542,343,21,79,21079,1001,1529,2546,1370,1031,1588,2723,1751,2032,3117,5269,3121,17445,8506,8939,16735,338,45,42,387,52631,3454,7623.0,8703.0
736,"Campbell County, Kentucky",45407,2744,2768,1747,2644,2840,2548,1690,21,37,21037,8185,8838,12262,6167,8231,8840,12711,7950,16416,17678,24973,14117,92861,45407,47454,86974,2982,917,622,1903,63050,21489,42510.0,48833.0
737,"Elliott County, Kentucky",4269,191,226,146,159,164,229,99,21,63,21063,740,1050,1064,685,388,569,893,740,1128,1619,1957,1425,7510,4269,3241,7205,268,0,13,36,32306,1779,2855.0,2995.0
738,"Larue County, Kentucky",7005,415,500,330,349,430,539,283,21,123,21123,914,1438,1964,1079,933,1274,2039,1352,1847,2712,4003,2431,14204,7005,7199,13186,503,53,228,461,47643,3030,6367.0,7301.0
739,"Mercer County, Kentucky",10617,667,725,432,593,689,554,396,21,167,21167,1478,1770,3106,1719,1458,1782,3237,2266,2936,3552,6343,3985,21592,10617,10975,20078,909,98,121,636,55093,4255,10585.0,11735.0
740,"Russell County, Kentucky",8648,602,480,404,445,740,436,348,21,207,21207,1085,1486,2412,1613,1154,1469,2640,1898,2239,2955,5052,3511,17778,8648,9130,16823,54,142,497,672,38390,3767,8174.0,8939.0
741,"Washington County, Kentucky",5900,335,402,217,391,395,390,204,21,229,21229,945,1010,1593,930,829,1003,1690,1221,1774,2013,3283,2151,12023,5900,6123,10828,644,106,157,511,53743,2659,5636.0,6223.0
742,"Barren County, Kentucky",21118,1492,1417,937,1322,1391,1517,896,21,9,21009,3095,3756,5757,3156,2996,3974,6301,4369,6091,7730,12058,7525,43884,21118,22766,40712,1547,148,150,1415,41459,8863,18488.0,20079.0
743,"Hancock County, Kentucky",4523,320,227,216,254,314,204,210,21,91,21091,628,717,1250,709,553,724,1176,762,1181,1441,2426,1471,8720,4523,4197,8380,137,50,0,134,57217,1712,4295.0,4587.0
744,"Hardin County, Kentucky",54044,3638,3477,2367,3607,3734,3544,2165,21,93,21093,9708,10441,13786,6471,7954,10634,14464,8381,17662,21075,28250,14852,108527,54044,54483,86124,12569,2364,1240,6150,54367,19846,43156.0,48941.0
745,"McLean County, Kentucky",4580,276,357,242,237,260,365,182,21,149,21149,565,756,1286,814,560,797,1331,971,1125,1553,2617,1785,9283,4580,4703,8990,116,21,8,80,51861,1838,4566.0,4782.0
746,"Powell County, Kentucky",6033,423,386,248,381,445,443,236,21,197,21197,888,1165,1653,866,844,1229,1653,1040,1732,2394,3306,1906,12304,6033,6271,11920,44,74,28,206,37469,2738,4957.0,5344.0
747,"Caldwell County, Kentucky",6249,353,467,362,342,422,412,93,21,33,21033,947,925,1672,1139,807,1107,1756,1514,1754,2032,3428,2653,12702,6249,6453,11813,796,0,0,318,44775,2997,5975.0,6436.0
748,"Boyd County, Kentucky",23854,1463,1609,941,1309,1498,1244,868,21,19,21019,3285,4649,6728,3951,2940,4252,6654,5063,6225,8901,13382,9014,47682,23854,23828,44852,1096,142,336,866,48308,8950,20454.0,21741.0
749,"Fayette County, Kentucky",157231,10062,9707,5346,9501,9239,8846,5191,21,67,21067,35835,33150,36202,17770,35828,32271,38725,23769,71663,65421,74927,41539,320601,157231,163370,239996,46844,12028,9015,23063,57291,69105,136315.0,152664.0
750,"Johnson County, Kentucky",11121,747,735,456,622,722,727,419,21,115,21115,1531,2060,3058,1871,1449,2157,3281,2136,2980,4217,6339,4007,22634,11121,11513,22018,111,341,24,74,37055,4044,9572.0,10193.0
751,"Morgan County, Kentucky",7481,339,296,310,297,273,347,207,21,175,21175,1325,1738,2017,1049,671,1064,1811,1137,1996,2802,3828,2186,13288,7481,5807,12461,452,78,29,179,36134,3086,4775.0,5535.0
752,"Pulaski County, Kentucky",31316,1875,1907,1271,1944,1888,2073,1198,21,199,21199,4449,5439,8778,5415,4387,5741,9213,6590,8836,11180,17991,12005,64350,31316,33034,61976,572,529,229,1603,39998,12277,28041.0,31537.0
753,"Adair County, Kentucky",9540,535,507,385,438,437,532,333,21,1,21001,1811,1566,2482,1672,1679,1570,2794,1899,3490,3136,5276,3571,19222,9540,9682,18239,603,120,22,376,38021,3727,8233.0,8766.0
754,"Breathitt County, Kentucky",6515,405,303,274,410,284,359,202,21,25,21025,1024,1215,1909,980,931,1202,1917,1157,1955,2417,3826,2137,12977,6515,6462,12602,171,43,51,123,27344,2639,5738.0,5667.0
755,"Hart County, Kentucky",9211,677,491,382,672,720,486,452,21,99,21099,1374,1493,2648,1355,1252,1513,2714,1709,2626,3006,5362,3064,18729,9211,9518,17480,766,91,0,346,38396,3437,7264.0,8369.0
756,"Trimble County, Kentucky",4221,240,192,192,207,155,378,166,21,223,21223,586,694,1302,675,588,792,1261,790,1174,1486,2563,1465,8558,4221,4337,8247,14,0,78,263,53056,1864,3798.0,4319.0
757,"Hickman County, Kentucky",2137,90,86,46,108,83,191,98,21,105,21105,241,392,656,463,256,397,606,634,497,789,1262,1097,4510,2137,2373,3913,377,32,20,83,42929,898,2157.0,2199.0
758,"Lyon County, Kentucky",4359,110,157,80,163,219,101,127,21,143,21143,642,862,1351,963,397,464,1195,1246,1039,1326,2546,2209,8271,4359,3912,7580,474,31,15,154,52528,2073,3962.0,4228.0
759,"Lewis County, Kentucky",6717,416,369,255,387,381,440,246,21,135,21135,949,1135,1928,1164,850,1200,1962,1234,1799,2335,3890,2398,13417,6717,6700,13117,90,19,0,0,31147,2533,5298.0,5883.0
760,"Woodford County, Kentucky",12448,796,854,447,675,860,697,704,21,239,21239,1541,2352,3627,2007,1890,2313,4068,2663,3431,4665,7695,4670,26318,12448,13870,24118,1196,107,251,1767,63820,5610,13563.0,15211.0
761,"Leslie County, Kentucky",5045,154,300,239,423,194,395,121,21,131,21131,744,924,1494,808,692,901,1528,984,1436,1825,3022,1792,10283,5045,5238,10039,15,39,40,51,31627,1889,4492.0,4814.0
762,"Lawrence County, Kentucky",7768,564,542,318,479,531,468,277,21,127,21127,1051,1370,2130,1239,1018,1435,2258,1437,2069,2805,4388,2676,15671,7768,7903,15490,29,32,5,185,32798,2842,6042.0,6955.0
763,"McCracken County, Kentucky",31322,2138,1810,1198,1911,1734,2091,1249,21,145,21145,4313,5662,8599,5282,4418,6071,9103,7369,8731,11733,17702,12651,65268,31322,33946,55515,6843,573,409,1648,46080,12961,31307.0,33554.0
764,"Brule County, South Dakota",2603,195,145,106,129,158,207,119,46,15,46015,314,433,722,420,293,425,814,510,607,858,1536,930,5258,2603,2655,4541,26,15,6,147,57196,942,2288.0,2490.0
765,"Gregory County, South Dakota",2149,151,138,95,110,144,125,64,46,53,46053,247,342,548,471,188,316,537,553,435,658,1085,1024,4186,2149,2037,3689,0,74,20,37,43438,811,2091.0,2259.0
766,"Minnehaha County, South Dakota",95110,7274,6931,3677,7190,6138,6501,3444,46,99,46099,16295,20719,22923,10729,15598,18812,22586,13295,31893,39531,45509,24024,188674,95110,93564,161852,10709,3939,2586,9417,61772,37634,78263.0,92326.0
767,"Clark County, South Dakota",1854,174,120,51,175,139,93,54,46,25,46025,250,292,474,341,229,262,441,438,479,554,915,779,3685,1854,1831,3504,8,17,66,120,48980,792,1657.0,1850.0
768,"Kingsbury County, South Dakota",2533,161,142,97,158,154,143,76,46,77,46077,288,419,709,545,272,385,646,577,560,804,1355,1122,4944,2533,2411,4839,0,11,57,110,61699,1125,2551.0,2779.0
769,"Clay County, South Dakota",6833,400,289,174,317,315,290,182,46,27,46027,2637,946,1211,785,3064,877,1210,869,5701,1823,2421,1654,13957,6833,7124,12357,260,403,187,419,50724,2716,5069.0,5698.0
770,"Dewey County, South Dakota",2893,401,293,147,325,283,272,149,46,41,46041,443,452,620,250,485,493,623,310,928,945,1243,560,5833,2893,2940,1161,5,5,5,59,47475,608,1708.0,1966.0
771,"Hughes County, South Dakota",8611,582,839,306,611,565,535,307,46,65,46065,1204,1616,2263,1444,1266,1853,2344,1516,2470,3469,4607,2960,17608,8611,8997,14808,24,3,116,563,64783,3436,8175.0,8723.0
772,"Sanborn County, South Dakota",1235,129,92,38,92,55,72,40,46,111,46111,158,223,305,236,136,177,335,237,294,400,640,473,2379,1235,1144,2292,0,11,34,89,56875,590,1123.0,1185.0
773,"Hand County, South Dakota",1643,96,113,44,92,130,83,57,46,59,46059,245,229,462,367,180,224,423,424,425,453,885,791,3256,1643,1613,3194,4,19,0,54,54155,747,1818.0,1836.0
774,"Yankton County, South Dakota",11836,669,614,440,701,646,716,375,46,135,46135,1809,2400,3383,1870,1509,1666,2960,2308,3318,4066,6343,4178,22717,11836,10881,20983,357,43,87,1026,58342,5203,9623.0,10900.0
775,"Beadle County, South Dakota",9313,757,777,412,765,688,704,291,46,5,46005,1344,1740,2313,1410,1171,1407,2293,1714,2515,3147,4606,3124,18346,9313,9033,14813,216,1673,1143,1845,52313,3339,6772.0,7081.0
776,"Davison County, South Dakota",9841,503,663,355,626,572,601,521,46,35,46035,1856,1930,2427,1533,1520,1657,2488,2045,3376,3587,4915,3578,19871,9841,10030,18401,273,145,259,620,50570,4051,7952.0,8454.0
777,"Jerauld County, South Dakota",1001,70,45,24,38,73,54,31,46,73,46073,80,153,282,258,74,161,246,340,154,314,528,598,2018,1001,1017,1938,0,0,30,61,49632,473,967.0,1006.0
778,"Stanley County, South Dakota",1619,128,132,54,76,108,48,31,46,117,46117,144,268,447,335,181,248,389,317,325,516,836,652,3017,1619,1398,2745,0,0,0,88,71382,718,1567.0,1652.0
779,"Potter County, South Dakota",1173,86,94,25,71,67,52,47,46,107,46107,122,176,320,293,139,134,281,351,261,310,601,644,2315,1173,1142,2119,0,41,15,37,54583,561,1337.0,1380.0
780,"Charles Mix County, South Dakota",4705,408,366,233,365,394,357,201,46,23,46023,644,702,1099,796,639,699,1080,909,1283,1401,2179,1705,9349,4705,4644,5906,8,11,20,334,50481,1497,3433.0,3783.0
781,"Marshall County, South Dakota",2549,203,173,138,176,195,172,64,46,91,46091,298,449,631,484,273,341,590,531,571,790,1221,1015,4891,2549,2342,4259,31,0,157,408,63723,954,1947.0,2178.0
782,"Perkins County, South Dakota",1504,82,71,80,90,64,104,26,46,105,46105,204,222,402,337,128,221,402,358,332,443,804,695,2897,1504,1393,2753,0,0,4,29,57981,569,1606.0,1669.0
783,"Whitley County, Kentucky",17701,1375,1134,710,1342,1215,1146,725,21,235,21235,3264,3019,4247,2538,3064,3084,4690,3164,6328,6103,8937,5702,36131,17701,18430,35062,319,87,81,465,39005,6979,13774.0,15347.0
784,"Floyd County, Kentucky",17813,1139,1102,750,1037,987,1102,580,21,71,21071,2679,3296,4851,2819,2464,3367,5547,3559,5143,6663,10398,6378,36456,17813,18643,35532,356,121,50,306,32730,6767,16540.0,16381.0
785,"Kenton County, Kentucky",81938,5694,6190,3375,5396,5884,5025,3078,21,117,21117,13204,16869,21341,10126,12660,16829,21873,12985,25864,33698,43214,23111,165668,81938,83730,149303,7640,2108,2293,5352,64339,34057,71998.0,82183.0
786,"Magoffin County, Kentucky",6238,411,343,257,366,333,434,241,21,153,21153,860,1100,1835,961,815,1107,1825,1132,1675,2207,3660,2093,12491,6238,6253,12470,4,13,0,133,28147,2351,5116.0,5446.0
787,"Rowan County, Kentucky",11806,686,591,366,649,594,642,402,21,205,21205,3548,1859,2582,1474,3844,1884,2821,1865,7392,3743,5403,3339,24507,11806,12701,23515,375,196,44,421,38230,4699,8848.0,10058.0
788,"Taylor County, Kentucky",12527,860,943,478,765,643,855,499,21,217,21217,2451,2019,3154,1892,2358,2065,3299,2560,4809,4084,6453,4452,25571,12527,13044,23349,1095,273,55,618,44522,4974,11306.0,12510.0
789,"Carlisle County, Kentucky",2338,184,123,89,130,129,168,82,21,39,21039,311,404,614,428,304,431,643,559,615,835,1257,987,4784,2338,2446,4581,38,38,7,112,45109,935,2601.0,2638.0
790,"Estill County, Kentucky",7015,385,496,283,401,424,429,263,21,65,21065,976,1272,2035,1173,907,1220,2092,1473,1883,2492,4127,2646,14224,7015,7209,14096,16,2,2,15,31688,2910,5545.0,6540.0
791,"Rapides Parish, Louisiana",63380,4512,4933,2938,4381,3991,4724,2738,22,79,22079,10378,11640,15673,8883,9904,12406,17525,11921,20282,24046,33198,20804,130970,63380,67590,83120,41341,1721,783,4123,47269,23143,56844.0,58861.0
792,"Tangipahoa Parish, Louisiana",63939,4688,4344,2604,4819,4303,4426,2471,22,105,22105,11545,12556,15161,8259,12296,12897,16674,10232,23841,25453,31835,18491,132057,63939,68118,88627,38910,989,375,5642,47832,21917,52416.0,57650.0
793,"West Carroll Parish, Louisiana",5593,312,347,236,289,361,348,160,22,123,22123,807,1080,1460,881,627,1094,1382,1187,1434,2174,2842,2068,11041,5593,5448,8842,1778,0,237,425,38500,2099,4759.0,5052.0
794,"Caldwell Parish, Louisiana",5239,358,460,192,265,327,300,154,22,21,22021,920,892,1339,804,690,785,1224,1008,1610,1677,2563,1812,9992,5239,4753,8163,1638,31,69,320,37691,1841,4692.0,4762.0
795,"East Carroll Parish, Louisiana",4309,111,276,31,363,70,141,51,22,35,22035,1451,891,900,422,342,486,760,574,1793,1377,1660,996,7096,4309,2787,2084,4945,0,13,39,22346,684,2939.0,3036.0
796,"Evangeline Parish, Louisiana",17218,1132,1277,703,1142,1131,1103,713,22,39,22039,3302,3172,4181,2283,2503,2833,4160,2786,5805,6005,8341,5069,33589,17218,16371,22794,9273,158,726,1254,31965,5090,14882.0,15412.0
797,"St. Bernard Parish, Louisiana",22625,1671,1732,866,1736,1906,1564,936,22,87,22087,3659,4862,5459,2377,3800,5348,5615,2736,7459,10210,11074,5113,46266,22625,23641,32097,10757,1170,906,4655,44661,5960,15815.0,17649.0
798,"West Baton Rouge Parish, Louisiana",12738,795,998,452,974,952,772,582,22,121,22121,2192,2820,3219,1546,2016,2622,3512,1933,4208,5442,6731,3479,26101,12738,13363,15222,10458,16,82,818,65385,4643,12712.0,14097.0
799,"Red River Parish, Louisiana",4023,189,375,167,357,286,334,142,22,81,22081,599,662,1113,663,563,726,1192,942,1162,1388,2305,1605,8565,4023,4542,4945,3350,0,12,204,33816,1361,4422.0,4132.0
800,"Natchitoches Parish, Louisiana",18562,1250,1203,765,1237,1236,1210,759,22,69,22069,4165,2847,3971,2749,4687,3012,4591,3475,8852,5859,8562,6224,38769,18562,20207,20665,15996,285,798,918,28567,5294,16621.0,16554.0
801,"Catahoula Parish, Louisiana",5132,253,274,175,321,322,268,177,22,25,22025,967,1208,1187,731,618,823,1197,908,1585,2031,2384,1639,9766,5132,4634,6513,3159,16,53,184,40129,1547,4856.0,4858.0
802,"Franklin Parish, Louisiana",9891,718,939,489,683,662,773,355,22,41,22041,1513,1815,2385,1495,1400,1841,2555,2078,2913,3656,4940,3573,20238,9891,10347,13233,6862,0,9,74,35282,3253,9162.0,9720.0
803,"Assumption Parish, Louisiana",10866,535,505,443,684,604,778,428,22,7,22007,1768,1870,2954,1817,1623,2027,3383,2085,3391,3897,6337,3902,22478,10866,11612,15158,6819,17,150,684,43759,3798,10904.0,11235.0
804,"Vermilion Parish, Louisiana",28936,2076,2146,1291,1991,2071,2130,1422,22,113,22113,4233,5485,7517,3966,4392,5764,8117,5042,8625,11249,15634,9008,59865,28936,30929,48737,8693,1189,254,2102,51945,10031,25632.0,27324.0
805,"Concordia Parish, Louisiana",10049,553,630,466,691,701,590,340,22,29,22029,1886,1981,2369,1426,1290,1625,2578,1914,3176,3606,4947,3340,19778,10049,9729,11433,8133,29,134,307,32500,3039,8872.0,8828.0
806,"Oxford County, Maine",28448,1323,1569,1099,1225,1359,1548,1013,23,17,23017,3536,4620,8894,5770,3361,4919,9218,6459,6897,9539,18112,12229,57550,28448,29102,55391,212,217,88,793,49204,14132,31201.0,31884.0
807,"Penobscot County, Maine",75235,3740,3892,2671,3350,3599,3886,2575,23,19,23019,14141,13136,21156,12426,12674,13355,22177,14923,26815,26491,43333,27349,151774,75235,76539,143465,1291,1492,462,2061,50808,35554,80540.0,77955.0
808,"Androscoggin County, Maine",52573,3248,3311,1952,3151,3347,3169,1878,23,1,23001,7982,9455,14918,8314,7950,9983,15262,10289,15932,19438,30180,18603,107602,52573,55029,98386,2562,839,267,1998,53509,23094,55601.0,58770.0
809,"Cumberland County, Maine",141794,7225,8222,5054,6815,7615,7533,4946,23,5,23005,22798,27576,40417,22835,22652,27749,43905,29298,45450,55325,84322,52133,292307,141794,150513,268151,8863,6350,1091,6061,73072,79931,171818.0,193945.0
810,"York County, Maine",99651,4983,5063,3757,4603,4894,5672,3471,23,31,23031,13705,17431,30284,18104,13663,18120,31721,22521,27368,35551,62005,40625,204316,99651,104665,195143,1778,2580,456,3507,67830,49918,114274.0,130346.0
811,"Somerset County, Maine",25021,1158,1528,913,1195,1537,1168,926,23,25,23025,3214,4115,7774,5007,2900,4338,7997,5438,6114,8453,15771,10445,50520,25021,25499,48759,313,194,60,554,44256,11323,26064.0,23529.0
812,"Worcester County, Maryland",25357,1147,1213,850,984,1109,1424,750,24,47,24047,3136,3746,7302,6474,3013,3753,7710,7665,6149,7499,15012,14139,51765,25357,26408,42965,6659,618,191,1811,63499,11968,28273.0,23587.0
813,"Talbot County, Maryland",17627,748,1043,709,913,895,977,575,24,41,24041,2042,2408,4943,4737,2041,2745,5536,5858,4083,5153,10479,10595,37167,17627,19540,30818,3887,503,247,2513,73547,8727,20553.0,21305.0
814,"Barnstable County, Massachusetts",102086,4020,4031,3317,3825,4275,4777,3095,25,1,25001,13561,13892,29906,28122,11231,14252,34496,35459,24792,28144,64402,63581,213496,102086,111410,195669,6210,3182,2565,6616,74336,58657,133862.0,146896.0
815,"Berkshire County, Massachusetts",61150,2781,2878,2190,2570,2830,3131,2070,25,3,25003,9434,9908,18017,12746,9265,9933,19602,15874,18699,19841,37619,28620,126425,61150,65275,114485,3548,2248,2209,5999,59230,31098,64803.0,56821.0
816,"Plymouth County, Massachusetts",250326,13980,15306,10952,13354,14653,16022,10581,25,23,25023,36532,42797,73857,39825,35434,44772,79256,50905,71966,87569,153113,90730,515303,250326,264977,427046,51537,7192,17164,20102,89489,120870,266863.0,259364.0
817,"Norfolk County, Massachusetts",336802,19176,19742,14187,18327,20488,20293,13402,25,21,25021,51369,65071,95489,49255,53509,68260,102643,66713,104878,133331,198132,115968,700437,336802,363635,543394,49756,77446,11563,31734,103291,199925,361562.0,379716.0
818,"Nantucket County, Massachusetts",5720,350,292,171,354,238,408,170,25,19,25019,768,1401,1626,784,725,1158,1548,847,1493,2559,3174,1631,11168,5720,5448,9748,871,71,95,465,107717,3339,6406.0,7297.0
819,"Allegan County, Michigan",58027,3639,3938,2603,3556,3865,3941,2449,26,5,26005,8191,10456,16238,8664,7614,10414,16299,9978,15805,20870,32537,18642,116143,58027,58116,108625,1569,802,1774,8532,62965,24262,55786.0,67182.0
820,"Alger County, Michigan",5075,156,214,124,173,205,164,134,26,3,26003,882,897,1444,1142,419,533,1333,1115,1301,1430,2777,2257,9151,5075,4076,7773,702,13,5,144,45570,2082,4518.0,5135.0
821,"Oceana County, Michigan",13381,710,852,573,736,866,857,522,26,127,26127,1918,2066,3735,2574,1600,2039,3607,2808,3518,4105,7342,5382,26416,13381,13035,24986,293,63,347,3934,50104,5032,11930.0,14080.0
822,"Clare County, Michigan",15242,799,1030,544,878,863,745,533,26,35,26035,1939,2316,4489,3440,1894,2260,4555,3681,3833,4576,9044,7121,30651,15242,15409,29488,190,36,100,617,39565,5666,13389.0,16280.0
823,"Isabella County, Michigan",34337,1614,1622,1099,1684,1711,1703,992,26,73,26073,11765,5340,7213,3837,12983,5006,7503,4769,24748,10346,14716,8606,70688,34337,36351,62196,1916,1262,563,2799,45116,12944,25392.0,29409.0
824,"Tuscola County, Michigan",26626,1404,1677,1154,1340,1410,1443,973,26,157,26157,3683,4411,7876,4862,3369,4277,7857,5644,7052,8688,15733,10506,52939,26626,26313,50849,531,181,138,1808,49988,11055,25796.0,29495.0
825,"Alpena County, Michigan",14068,651,722,508,711,571,849,510,26,7,26007,1847,2294,4261,2963,1728,2171,4387,3525,3575,4465,8648,6488,28520,14068,14452,27603,165,176,44,393,43363,5725,14698.0,16966.0
826,"Midland County, Michigan",41012,2445,2804,1660,2150,2282,2706,1589,26,111,26111,6325,7505,11356,6608,5888,7391,11954,8383,12213,14896,23310,14991,83355,41012,42343,77659,1167,1916,542,2289,62625,19489,42506.0,49165.0
827,"Oscoda County, Michigan",4199,218,238,151,214,185,195,115,26,135,26135,435,525,1263,1105,469,495,1254,1122,904,1020,2517,2227,8248,4199,4049,7981,44,12,16,135,42335,1499,4073.0,4874.0
828,"Clinton County, Michigan",38704,2219,2445,1705,2147,2390,2595,1593,26,37,26037,5853,7049,10837,6011,5506,7113,11455,6886,11359,14162,22292,12897,78389,38704,39685,73354,1442,1183,348,3554,70390,16392,40655.0,47902.0
829,"Gratiot County, Michigan",21928,1010,1189,842,977,1307,950,696,26,57,26057,4286,4498,5742,3180,3048,3216,4937,3857,7334,7714,10679,7037,40916,21928,18988,37227,2346,183,92,2498,47848,7979,16465.0,19148.0
830,"Lenawee County, Michigan",49699,2671,2839,2069,2605,2526,3097,1829,26,91,26091,7922,9169,13717,8092,6898,8116,13653,9958,14820,17285,27370,18050,98381,49699,48682,91576,2471,305,767,7842,55450,20476,45939.0,53448.0
831,"Montcalm County, Michigan",32593,1720,2025,1355,1864,2080,1910,1165,26,117,26117,4789,6205,9362,5012,4173,5199,8618,5811,8962,11404,17980,10823,63413,32593,30820,60014,1387,224,233,2222,49448,12082,26609.0,32086.0
832,"St. Clair County, Michigan",79166,4181,4226,3391,3813,4175,5044,3168,26,147,26147,11322,13141,24028,13291,10408,13419,24309,15745,21730,26560,48337,29036,159247,79166,80081,148933,3554,1026,905,5373,56951,30603,78003.0,92063.0
833,"Washtenaw County, Michigan",181923,9206,9451,6284,8829,8678,10135,5950,26,161,26161,49931,33223,41380,22105,47797,32419,44066,27203,97728,65642,85446,49308,367000,181923,185077,269998,43795,33476,2787,17329,72586,91299,188578.0,216924.0
834,"Cass County, Michigan",25836,1377,1485,1005,1198,1416,1570,1016,26,27,26027,3456,4121,7754,4945,3211,4057,7709,5510,6667,8178,15463,10455,51523,25836,25687,45779,2666,431,535,2002,55107,9610,22595.0,26221.0
835,"Roscommon County, Michigan",11883,446,543,404,428,520,505,332,26,143,26143,1161,1344,3726,3780,1044,1453,3849,3837,2205,2797,7575,7617,23851,11883,11968,23020,39,69,31,449,42054,5189,13041.0,15018.0
836,"Branch County, Michigan",22481,1321,1409,888,1286,1435,1410,844,26,23,26023,3058,4215,6452,3693,2746,3449,5655,4207,5804,7664,12107,7900,43513,22481,21032,40858,1032,342,400,2071,51947,8830,17663.0,20540.0
837,"Jackson County, Michigan",80972,4594,5001,3171,4464,4308,4973,3010,26,75,26075,13155,15075,22650,12433,11334,12822,21907,14846,24489,27897,44557,27279,158636,80972,77664,138511,12350,1310,855,5605,53658,30514,69677.0,81032.0
838,"Macomb County, Michigan",423761,24464,25776,17478,23275,24804,25429,16713,26,99,26099,67678,78518,120698,62166,65587,80571,127961,82224,133265,159089,248659,144390,870325,423761,446564,704624,101734,34996,4851,22781,62855,162571,419312.0,496523.0
839,"Baraga County, Michigan",4657,172,238,167,178,191,231,134,26,13,26013,742,961,1301,879,420,535,1127,948,1162,1496,2428,1827,8421,4657,3764,6181,783,34,38,134,46065,1577,3490.0,4033.0
840,"Eaton County, Michigan",53603,3074,3181,2219,2930,3077,3265,2060,26,45,26045,8665,9828,14538,8852,8087,9872,15814,10748,16752,19700,30352,19600,109456,53603,55853,94564,7435,2552,1299,5901,64348,22580,56221.0,64451.0
841,"Upson County, Georgia",12482,868,626,566,900,652,969,477,13,293,13293,1886,2033,3437,2016,1916,2310,3827,2703,3802,4343,7264,4719,26236,12482,13754,17868,7290,119,144,606,37640,4042,10934.0,12899.0
842,"Washington County, Georgia",10465,572,608,389,574,513,690,371,13,303,13303,1831,2061,2809,1531,1310,1632,2795,2086,3141,3693,5604,3617,20436,10465,9971,8909,10856,137,159,506,38068,3013,8461.0,9462.0
843,"White County, Georgia",14398,610,811,597,676,749,868,650,13,311,13311,2240,2230,4056,2993,2060,2256,4320,3512,4300,4486,8376,6505,29489,14398,15091,27699,430,171,423,958,52493,5393,11823.0,14816.0
844,"Peach County, Georgia",13203,703,903,644,768,681,923,339,13,225,13225,2634,2228,3466,1835,2779,2467,3610,2375,5413,4695,7076,4210,27145,13203,13942,13261,12165,274,980,2092,46636,4653,10752.0,12546.0
845,"Paulding County, Georgia",77953,5388,5467,3865,5082,5742,6190,3880,13,223,13223,12145,16081,20835,7256,12072,17508,21975,9423,24217,33589,42810,16679,159825,77953,81872,119808,30604,1563,2140,10125,68370,30152,64890.0,85273.0
846,"Pierce County, Georgia",9699,620,920,446,642,500,681,347,13,229,13229,1274,1641,2674,1462,1272,1832,2511,1766,2546,3473,5185,3228,19250,9699,9551,16503,1799,0,587,973,42804,3602,7311.0,9047.0
847,"Pike County, Georgia",8964,490,596,432,399,473,757,441,13,231,13231,1275,1627,2522,1302,1372,1810,2576,1535,2647,3437,5098,2837,18327,8964,9363,16152,1641,97,78,298,64878,3789,8725.0,10715.0
848,"Richmond County, Georgia",97611,7196,6941,3710,6569,6336,6243,3785,13,245,13245,21887,18276,22324,11382,19608,19710,25972,16018,41495,37986,48296,27400,201852,97611,104241,74934,113946,3809,2913,9937,42728,29029,75515.0,86584.0
849,"Screven County, Georgia",6801,454,403,229,417,460,303,323,13,251,13251,1076,1261,1794,1153,1002,1168,2114,1401,2078,2429,3908,2554,13989,6801,7188,7783,5824,104,103,303,39842,2229,5715.0,6641.0
850,"Tattnall County, Georgia",14924,671,884,554,654,655,794,318,13,267,13267,3327,3728,3557,1526,1119,2143,2781,1994,4446,5871,6338,3520,25382,14924,10458,14907,7446,48,2504,2914,40730,3769,6903.0,8175.0
851,"Berrien County, Georgia",9384,598,724,371,610,744,516,443,13,19,13019,1235,1881,2376,1557,1288,1750,2610,1807,2523,3631,4986,3364,19152,9384,9768,15904,2247,212,359,971,40415,3098,6590.0,7731.0
852,"Montgomery County, Illinois",15134,737,769,493,754,960,644,506,17,135,17135,2381,3048,4276,2517,1546,2241,3905,3138,3927,5289,8181,5655,28828,15134,13694,27265,1078,75,77,510,52748,6156,12978.0,13701.0
853,"Whiteside County, Illinois",27705,1596,1659,1174,1591,1627,1829,1066,17,195,17195,3882,4600,7722,5138,3602,4654,7709,6233,7484,9254,15431,11371,56016,27705,28311,52852,936,341,579,6723,54232,11185,25582.0,27254.0
854,"Adams County, Illinois",32276,2060,2296,1194,2005,2179,2005,1130,17,1,17001,4602,5723,8494,5855,4597,5834,8728,7331,9199,11557,17222,13186,66085,32276,33809,61406,2731,527,113,1059,52993,14405,31951.0,33434.0
855,"Clinton County, Illinois",19604,1111,1252,762,982,823,1242,662,17,27,17027,2832,4112,5567,2830,2493,3229,5168,3431,5325,7341,10735,6261,37634,19604,18030,35247,1298,214,193,1175,66639,7868,17419.0,19139.0
856,"DeKalb County, Illinois",51753,3075,3107,2020,2934,2575,3662,1857,17,37,17037,13975,9167,11503,5613,14011,8928,11577,7069,27986,18095,23080,12682,104366,51753,52613,87649,8258,2379,3428,11637,63317,19130,43600.0,47717.0
857,"Edwards County, Illinois",3218,184,219,169,183,162,252,126,17,47,17047,412,531,905,594,361,533,864,756,773,1064,1769,1350,6455,3218,3237,6250,57,18,0,89,51080,1057,3347.0,3368.0
858,"Jasper County, Illinois",4773,335,344,184,262,288,345,190,17,79,17079,574,832,1366,860,582,784,1403,967,1156,1616,2769,1827,9594,4773,4821,9333,47,9,8,34,54256,2196,5136.0,5582.0
859,"Jefferson County, Illinois",19500,1239,1265,715,1164,1230,1080,712,17,81,17081,3053,3770,5229,3192,2387,3163,4867,3882,5440,6933,10096,7074,37985,19500,18485,33162,3177,438,93,1016,49896,6749,16999.0,17409.0
860,"Vermilion County, Illinois",38565,2529,2843,1584,2530,2280,2669,1540,17,183,17183,5689,7036,9926,6495,5209,6421,10314,8035,10898,13457,20240,14530,77563,38565,38998,63747,10920,759,549,3905,46515,14313,30570.0,31617.0
861,"Will County, Illinois",342031,20648,23445,17285,19984,22638,26427,16338,17,197,17197,53403,66935,94039,38699,49806,68367,95509,48215,103209,135302,189548,86914,689315,342031,347284,506424,77941,37809,44121,119765,86961,144500,300904.0,330593.0
862,"Williamson County, Illinois",33474,2064,2179,1188,1872,1881,2202,1175,17,199,17199,4648,6844,8883,5547,4459,6224,8857,6958,9107,13068,17740,12505,67102,33474,33628,60881,2874,785,666,1771,50734,13496,31852.0,33503.0
863,"Clark County, Illinois",7756,484,551,339,419,489,512,338,17,23,17023,1022,1343,2214,1312,1001,1313,2159,1729,2023,2656,4373,3041,15716,7756,7960,15220,107,98,92,248,56531,3518,7928.0,8340.0
864,"Douglas County, Illinois",9721,710,545,436,619,656,698,433,17,41,17041,1457,1803,2437,1517,1372,1761,2435,1928,2829,3564,4872,3445,19623,9721,9902,18792,135,131,176,1425,56714,3459,8169.0,8746.0
865,"Effingham County, Illinois",16958,1164,1113,678,1097,1029,1180,655,17,49,17049,2613,3158,4520,2534,2358,2972,4571,3317,4971,6130,9091,5851,34137,16958,17179,33128,231,180,251,719,56685,7098,17609.0,19041.0
866,"Fulton County, Illinois",18321,832,910,693,833,952,1014,613,17,57,17057,2812,3752,5074,3133,2041,2787,4619,3912,4853,6539,9693,7045,35092,18321,16771,33002,1325,28,104,1061,51643,7218,15797.0,16517.0
867,"Greene County, Illinois",6591,351,449,254,315,425,354,251,17,61,17061,994,1222,1879,1112,859,1066,1881,1390,1853,2288,3760,2502,13132,6591,6541,12723,184,27,63,159,49885,3156,5585.0,6224.0
868,"Hamilton County, Illinois",4072,220,244,251,227,298,221,78,17,65,17065,509,689,1119,767,481,703,1104,992,990,1392,2223,1759,8176,4072,4104,8114,33,12,17,61,54046,1453,4166.0,4316.0
869,"Hardin County, Illinois",1968,57,50,105,58,71,154,58,17,69,17069,203,420,520,490,225,336,583,486,428,756,1103,976,3939,1968,1971,3764,107,4,0,37,51250,668,2148.0,0.0
870,"Henry County, Illinois",24536,1356,1539,1110,1348,1294,1659,1007,17,73,17073,3274,4375,6611,4567,2862,4318,6804,5439,6136,8693,13415,10006,49267,24536,24731,46313,938,244,1081,2808,59933,10278,24643.0,25624.0
871,"Johnson County, Illinois",6940,295,300,238,271,413,224,191,17,87,17087,1235,1410,1866,1264,627,886,1591,1351,1862,2296,3457,2615,12494,6940,5554,10954,1408,44,42,395,52774,2324,6089.0,6442.0
872,"Knox County, Illinois",25586,1566,1317,901,1235,1244,1473,770,17,95,17095,4293,4683,6671,4670,3779,3937,6626,5858,8072,8620,13297,10528,50508,25586,24922,43219,4485,554,1095,2909,44129,9565,22243.0,22716.0
873,"Livingston County, Illinois",18429,972,1053,778,983,869,1157,690,17,105,17105,2717,3474,5196,2979,2295,2902,4876,3839,5012,6376,10072,6818,36040,18429,17611,33377,1520,308,263,1647,55160,7693,15269.0,17049.0
874,"Scott County, Illinois",2437,129,147,102,114,147,188,106,17,171,17171,299,413,741,443,298,438,724,553,597,851,1465,996,5005,2437,2568,4886,7,4,18,64,57118,1220,2608.0,2730.0
875,"Tazewell County, Illinois",65539,4057,4533,2712,3761,4326,4351,2452,17,179,17179,8972,12962,17417,10704,8445,12575,18074,13672,17417,25537,35491,24376,133195,65539,67656,127484,1645,1453,512,3116,63454,27434,64400.0,68358.0
876,"Warren County, Illinois",8169,440,482,346,563,501,569,351,17,187,17187,1487,1463,2030,1417,1442,1601,2181,1769,2929,3064,4211,3186,17146,8169,8977,15107,501,429,874,1640,50310,3276,7807.0,7916.0
877,"Harrison County, Indiana",19862,1191,1263,808,1090,1163,1434,821,18,61,18061,2654,3640,5834,3196,2497,3592,5799,3682,5151,7232,11633,6878,39940,19862,20078,38588,252,173,344,769,57712,9345,18558.0,20198.0
878,"LaPorte County, Indiana",56741,3301,3202,2099,3215,3056,3397,2062,18,91,18091,9402,11387,15409,8493,7180,9110,14787,10606,16582,20497,30196,19099,110154,56741,53413,91260,12169,639,2112,7269,53658,22128,45203.0,49469.0
879,"Wabash County, Indiana",15334,802,747,682,789,774,1037,607,18,169,18169,2539,2505,4232,2758,2433,2570,4202,3643,4972,5075,8434,6401,31389,15334,16055,30001,349,121,343,819,54259,6736,13468.0,14598.0
880,"Jasper County, Indiana",16731,1050,1276,839,880,1028,1141,709,18,73,18073,2510,3014,4416,2671,2410,2898,4538,3112,4920,5912,8954,5783,33447,16731,16716,31527,204,110,869,2012,63892,6550,13378.0,15495.0
881,"Martin County, Indiana",5158,320,249,240,299,242,353,180,18,101,18101,689,915,1462,890,692,821,1406,1061,1381,1736,2868,1951,10212,5158,5054,10025,77,18,2,117,52726,2097,4809.0,5155.0
882,"Porter County, Indiana",83467,4729,5146,3685,4443,5259,4969,3509,18,127,18127,13122,16239,22565,12216,12350,16378,23585,14676,25472,32617,46150,26892,168636,83467,85169,153462,6386,2350,1982,16813,71152,38034,77190.0,86284.0
883,"Ripley County, Indiana",14040,843,903,649,804,969,874,630,18,137,18137,2090,2382,3853,2244,1892,2479,4022,2681,3982,4861,7875,4925,28391,14040,14351,27613,111,275,49,520,56332,6291,12810.0,14280.0
884,"Spencer County, Indiana",10264,562,552,432,556,651,633,394,18,147,18147,1329,1765,3008,1870,1285,1659,2935,2070,2614,3424,5943,3940,20447,10264,10183,19905,143,69,66,593,57305,4695,9979.0,10781.0
885,"Tipton County, Indiana",7538,417,510,315,387,385,474,329,18,159,18159,1107,1192,2299,1361,892,1209,2234,1714,1999,2401,4533,3075,15162,7538,7624,14586,16,48,164,425,58118,3649,7510.0,8124.0
886,"Vigo County, Indiana",54561,3246,3142,2002,2923,2901,2946,1747,18,167,18167,12486,10184,13189,7174,11038,8648,12716,9979,23524,18832,25905,17153,107459,54561,52898,93609,7230,1987,804,2886,45230,20413,39818.0,43593.0
887,"Warrick County, Indiana",30667,1699,2135,1415,1806,2300,1911,1430,18,173,18173,4007,5575,8701,4881,3781,5873,8799,5713,7788,11448,17500,10594,62280,30667,31613,58364,1028,1660,347,1165,73482,13715,29589.0,33884.0
888,"DeKalb County, Indiana",21411,1355,1402,929,1338,1547,1322,851,18,33,18033,3285,3849,5831,3032,2996,3811,5905,3746,6281,7660,11736,6778,42927,21411,21516,41724,300,177,100,1202,56421,8921,16902.0,19656.0
889,"LaGrange County, Indiana",19811,1907,1611,1101,1723,1595,1855,1068,18,87,18087,3313,3176,4259,2460,2765,3233,4344,2799,6078,6409,8603,5259,39193,19811,19382,38347,75,35,53,1587,64498,4311,9566.0,10633.0
890,"Rush County, Indiana",8092,469,494,358,458,380,677,410,18,139,18139,1137,1411,2395,1306,1123,1387,2446,1668,2260,2798,4841,2974,16641,8092,8549,16173,280,19,26,275,54346,3790,7214.0,7938.0
891,"Boone County, Indiana",32417,2153,2317,1536,2025,2335,2526,1434,18,11,18011,4307,6389,8922,3750,4153,6699,9243,4712,8460,13088,18165,8462,65544,32417,33127,60837,1137,1943,362,1966,83077,15334,32178.0,38622.0
892,"Gogebic County, Michigan",8019,279,449,211,280,319,310,200,26,53,26053,1142,1428,2368,1837,843,1009,2066,2015,1985,2437,4434,3852,15061,8019,7042,13708,582,82,12,220,38839,3016,7329.0,8279.0
893,"Meeker County, Minnesota",11800,755,751,504,658,724,811,485,27,93,27093,1509,1963,3269,2113,1294,1884,3076,2373,2803,3847,6345,4486,23105,11800,11305,22410,98,71,191,924,63452,4650,12282.0,13493.0
894,"Rice County, Minnesota",33765,1889,1957,1248,1869,2130,2063,1189,27,131,27131,6855,6391,8687,4564,6414,5328,7965,5462,13269,11719,16652,10026,66185,33765,32420,56681,3765,1411,2404,5380,68584,12960,32443.0,35582.0
895,"Red Lake County, Minnesota",2041,145,139,86,115,124,143,88,27,125,27125,217,352,568,389,201,366,524,413,418,718,1092,802,4015,2041,1974,3821,20,0,17,155,58576,817,1881.0,2190.0
896,"Clay County, Minnesota",31334,2408,2237,1225,2123,2423,1827,1185,27,27,27027,6661,6395,6639,3689,7133,6040,6876,4505,13794,12435,13515,8194,63446,31334,32112,57471,2332,803,341,2872,65269,12176,29398.0,32215.0
897,"Fillmore County, Minnesota",10542,712,794,409,643,720,674,396,27,45,27045,1241,1804,2832,1979,1153,1740,2761,2320,2394,3544,5593,4299,20949,10542,10407,20442,107,105,87,344,61207,4455,11055.0,12136.0
898,"Polk County, Minnesota",16038,1180,1006,628,984,1062,946,579,27,119,27119,2498,2718,4187,2596,2130,2670,4034,3078,4628,5388,8221,5674,31521,16038,15483,28896,686,312,369,2046,59343,6201,14796.0,15581.0
899,"Sibley County, Minnesota",7581,440,525,331,407,534,462,301,27,143,27143,988,1381,2175,1214,858,1260,2011,1478,1846,2641,4186,2692,14892,7581,7311,14199,157,107,270,1335,63439,3150,7774.0,8451.0
900,"Watonwan County, Minnesota",5511,512,300,243,318,419,345,180,27,165,27165,792,892,1358,1046,740,901,1415,1143,1532,1793,2773,2189,10972,5511,5461,9411,102,129,1197,2797,54065,2111,4998.0,5191.0
901,"Big Stone County, Minnesota",2488,171,134,80,123,158,136,87,27,11,27011,302,374,710,573,251,343,702,708,553,717,1412,1281,4996,2488,2508,4878,3,3,7,91,53900,1111,2755.0,2972.0
902,"Cass County, Minnesota",14967,888,938,506,761,848,819,492,27,21,27021,1542,2142,4273,3743,1498,2034,4186,3663,3040,4176,8459,7406,29268,14967,14301,24720,122,187,68,658,52204,5871,15999.0,18251.0
903,"Hubbard County, Minnesota",10627,584,690,351,549,604,674,364,27,57,27057,1138,1598,3053,2587,993,1579,2993,2636,2131,3177,6046,5223,21019,10627,10392,19634,135,140,211,448,56709,4706,11505.0,12927.0
904,"Martin County, Minnesota",9952,548,853,339,525,623,512,362,27,91,27091,1317,1534,2721,2073,1239,1442,2715,2482,2556,2976,5436,4555,19852,9952,9900,19117,92,102,212,888,52798,4156,10531.0,11038.0
905,"Nobles County, Minnesota",11256,909,805,442,916,870,704,390,27,105,27105,1775,2055,2849,1552,1510,1830,2322,1936,3285,3885,5171,3488,21734,11256,10478,16901,928,1508,1684,6047,55304,3272,8632.0,8708.0
906,"Sherburne County, Minnesota",48249,3090,4017,2250,3140,3807,3194,2208,27,141,27141,7386,10317,13010,4722,6228,9926,12172,5539,13614,20243,25182,10261,94463,48249,46214,87265,2335,1213,1206,2451,89250,18714,48283.0,55456.0
907,"Carver County, Minnesota",50618,3418,4053,2528,3179,3886,3955,2431,27,19,27019,6372,10374,14556,5259,6423,10625,14463,6369,12795,20999,29019,11628,101949,50618,51331,93751,1864,2893,715,4272,101496,23452,55696.0,66104.0
908,"McLeod County, Minnesota",17955,1095,1270,792,982,1071,1239,685,27,85,27085,2544,3328,4808,2946,2315,3160,4826,3599,4859,6488,9634,6545,35832,17955,17877,34034,212,210,805,2222,62121,6176,18807.0,20909.0
909,"Ramsey County, Minnesota",265450,19495,18124,10043,18526,17395,16651,9512,27,123,27123,50179,54871,62571,32875,51300,55159,66586,43863,101479,110030,129157,76738,544442,265450,278992,361226,65848,78585,11592,40748,64660,119821,273143.0,294507.0
910,"Winona County, Minnesota",25126,1208,1309,873,1235,1169,1327,779,27,169,27169,6587,3968,6076,3844,6874,3672,6056,4487,13461,7640,12132,8331,50725,25126,25599,47455,651,1340,228,1502,59329,9696,26074.0,27105.0
911,"Dodge County, Minnesota",10393,720,873,474,587,630,937,493,27,39,27039,1398,2025,2811,1375,1336,1974,2713,1606,2734,3999,5524,2981,20669,10393,10276,19571,69,191,471,1028,74575,4415,10654.0,12953.0
912,"Crow Wing County, Minnesota",31961,1758,2161,1216,1766,1944,1944,1149,27,35,27035,4049,5415,8663,6668,3810,5174,9004,7465,7859,10589,17667,14133,64217,31961,32256,61499,526,272,161,958,56549,12642,35842.0,40160.0
913,"Wright County, Minnesota",67939,4940,5773,3352,4489,4950,5750,3069,27,171,27171,8756,14046,17974,7600,8356,14007,17117,8761,17112,28053,35091,16361,134438,67939,66499,126547,1905,1495,1503,3953,84974,26714,69618.0,86535.0
914,"Lincoln County, Minnesota",2860,177,218,102,169,182,186,101,27,81,27081,319,458,777,624,302,418,685,774,621,876,1462,1398,5677,2860,2817,5533,25,9,12,118,53077,1253,3019.0,3114.0
915,"Mille Lacs County, Minnesota",13001,866,872,643,796,937,761,502,27,95,27095,1692,2355,3583,2136,1599,2257,3477,2535,3291,4612,7060,4671,25865,13001,12864,23321,120,175,117,640,56135,4819,13017.0,14658.0
916,"Carlton County, Minnesota",18634,969,1192,741,905,1110,1180,684,27,17,27017,2577,3733,5342,2818,2068,3038,4775,3239,4645,6771,10117,6057,35633,18634,16999,31849,670,205,22,634,63098,7299,18211.0,20361.0
917,"Kanabec County, Minnesota",8136,408,440,323,420,482,501,300,27,65,27065,1022,1331,2453,1569,891,1330,2347,1682,1913,2661,4800,3251,16089,8136,7953,15435,35,92,27,256,57163,3389,8177.0,9234.0
918,"St. Clair County, Alabama",44013,2560,3108,1861,2611,2428,2945,1562,1,115,01115,6328,8629,12071,6490,5806,8616,12181,7827,12134,17245,24252,14317,87989,44013,43976,76774,8447,745,619,2133,58308,15585,38400.0,44346.0
919,"Cullman County, Alabama",40759,2478,2263,1663,2637,2394,2683,1597,1,43,01043,5979,7670,10976,6740,5902,7340,11165,8376,11881,15010,22141,15116,82853,40759,42094,78804,1073,314,747,3611,44918,13998,37873.0,41751.0
920,"Houston County, Alabama",50190,3334,3187,2207,3067,3263,3303,2138,1,69,01069,7425,9312,13104,7767,7691,10317,14448,10285,15116,19629,27552,18052,104702,50190,54512,72344,28157,930,634,3479,47580,16681,42639.0,45750.0
921,"Tuscaloosa County, Alabama",100006,6371,6154,3683,6031,6140,5631,3562,1,125,01125,25369,18415,22461,11507,26532,19498,24739,15166,51901,37913,47200,26673,207305,100006,107299,133130,66307,3341,1786,7702,53326,37067,82700.0,89760.0
922,"Coffee County, Alabama",25479,1674,1522,1099,1533,1784,1618,1013,1,31,01031,3858,5015,6539,3756,3611,4914,6916,4794,7469,9929,13455,8550,51662,25479,26183,39118,8733,745,696,3763,55637,8312,20767.0,22180.0
923,"Chilton County, Alabama",21459,1226,1628,1093,1533,1597,1341,901,1,21,01021,3280,4263,5450,3203,3110,4377,5888,3849,6390,8640,11338,7052,44055,21459,22596,36835,4041,195,1530,3457,47468,7974,18369.0,19260.0
924,"Coosa County, Alabama",5462,171,250,196,193,190,298,136,1,37,01037,730,835,1780,1133,613,897,1671,1297,1343,1732,3451,2430,10757,5462,5295,7078,3615,0,55,109,38990,1935,5252.0,5472.0
925,"Etowah County, Alabama",49564,3051,3355,2057,2865,2748,3281,1968,1,55,01055,7554,8910,13536,8257,7409,9591,14322,11000,14963,18501,27858,19257,102748,49564,53184,82027,16330,764,1181,3982,44637,17854,44164.0,47460.0
926,"Lamar County, Alabama",6783,396,435,291,326,366,511,253,1,75,01075,890,1046,1960,1293,806,1211,1939,1690,1696,2257,3899,2983,13885,6783,7102,12154,1479,17,121,229,38364,2536,6966.0,7187.0
927,"Butler County, Alabama",9081,458,701,418,691,591,575,393,1,13,01013,1357,1716,2207,1596,1367,1982,2844,2304,2724,3698,5051,3900,19828,9081,10747,10280,9001,69,42,277,40688,3334,8732.0,9466.0
928,"Walker County, Alabama",31453,2049,2211,1380,1874,1758,2032,1149,1,127,01127,4645,5374,8627,5364,4401,5661,8955,6827,9046,11035,17582,12191,64110,31453,32657,58077,3961,331,467,1595,43629,10569,29472.0,31106.0
929,"Greene County, Alabama",3846,353,183,39,225,374,109,291,1,63,01063,690,536,986,749,552,674,1229,1024,1242,1210,2215,1773,8324,3846,4478,1439,6618,0,8,145,24145,822,4880.0,4771.0
930,"Bullock County, Alabama",5571,260,383,232,282,255,338,162,1,11,01011,1010,1127,1640,703,688,849,1166,937,1698,1976,2806,1640,10248,5571,4677,2244,7666,50,210,262,37785,982,4710.0,4603.0
931,"Chambers County, Alabama",16089,999,947,628,1044,848,1088,573,1,17,01017,2561,2733,4512,2771,2473,3003,4843,3699,5034,5736,9355,6470,33660,16089,17571,19423,13316,376,91,800,42289,4559,13900.0,15269.0
932,"Haines Borough, Alaska",1297,79,137,2,106,60,134,59,2,100,02100,52,293,304,365,97,187,310,268,149,480,614,633,2518,1297,1221,2055,0,33,7,113,58059,528,,
933,"Juneau City and Borough, Alaska",16504,970,1055,644,905,963,896,565,2,110,02110,2732,3418,4794,1945,2531,3333,4436,2094,5263,6751,9230,4039,32227,16504,15723,21917,320,2231,482,2186,88390,6828,,
934,"Yukon-Koyukuk Census Area, Alaska",2879,197,262,122,203,234,176,115,2,290,02290,449,513,721,433,385,414,634,337,834,927,1355,770,5377,2879,2498,1223,4,38,8,143,41413,458,,
935,"Denali Borough, Alaska",1201,38,23,18,26,18,28,38,2,68,02068,280,204,434,132,209,264,385,77,489,468,819,209,2246,1201,1045,1892,26,58,5,7,81719,637,,
936,"Hoonah-Angoon Census Area, Alaska",1142,47,33,16,43,74,56,18,2,105,02105,137,201,425,248,100,139,376,191,237,340,801,439,2139,1142,997,986,68,34,24,146,59803,416,,
937,"Wrangell City and Borough, Alaska",1357,53,53,78,67,36,67,29,2,275,02275,154,180,449,305,142,157,383,264,296,337,832,569,2502,1357,1145,1577,1,18,34,126,53894,509,,
938,"Pima County, Arizona",505666,29730,30234,19011,28595,29911,29523,18394,4,19,04019,98560,90114,116711,89571,92773,87872,126683,107790,191333,177986,243394,197361,1027207,505666,521541,781004,36581,30011,87891,382585,53379,187335,421640.0,501058.0
939,"Gila County, Arizona",26507,1501,1721,903,1434,1340,1612,876,4,7,04007,3164,3615,6866,7392,3067,3447,7456,7807,6231,7062,14322,15199,53546,26507,27039,41171,375,439,1184,10038,43524,8952,36697.0,27726.0
940,"Cochise County, Arizona",63967,3718,4506,2314,3696,3719,3826,2254,4,3,04003,10581,11577,14849,13069,8344,10027,15825,14209,18925,21604,30674,27278,125867,63967,61900,107581,5132,2445,3462,44626,49260,20271,50015.0,54381.0
941,"Apache County, Arizona",35155,2400,2687,1623,2413,2682,2982,1881,4,1,04001,6047,6262,8401,4852,5821,5820,8915,5842,11868,12082,17316,10694,71511,35155,36356,16328,373,246,549,4531,32508,6045,27661.0,24333.0
942,"Yuma County, Arizona",107841,7676,7489,4339,7395,7204,7159,4366,4,27,04027,22419,19459,20433,18426,16698,16904,21627,20274,39117,36363,42060,38700,209468,107841,101627,159864,4533,2777,33190,133549,45243,26502,53010.0,66677.0
943,"Navajo County, Arizona",54721,3910,4150,2582,3820,3962,4261,2394,4,17,04017,8672,9232,12812,8992,7595,8776,13671,10070,16267,18008,26483,19062,109270,54721,54549,51496,1005,652,4033,12479,40067,11399,40294.0,51464.0
944,"Clay County, Arkansas",7329,387,420,295,434,328,561,283,5,21,05021,1032,1320,1971,1378,963,1214,2014,1763,1995,2534,3985,3141,14889,7329,7560,14275,100,4,216,307,37233,3108,5200.0,5178.0
945,"Drew County, Arkansas",9023,717,502,335,406,372,700,394,5,43,05043,1914,1537,2020,1358,1874,1541,2338,1769,3788,3078,4358,3127,18417,9023,9394,12611,5289,60,198,632,46997,3416,6595.0,6879.0
946,"Randolph County, Arkansas",8839,585,531,429,482,425,693,358,5,121,05121,1290,1584,2211,1565,1155,1481,2302,1960,2445,3065,4513,3525,17695,8839,8856,16842,192,21,122,367,37218,3556,6379.0,6769.0
947,"Boone County, Arkansas",18440,1182,1317,752,1153,1142,1191,675,5,9,05009,2703,3100,4736,3455,2452,3216,4926,4136,5155,6316,9662,7591,37331,18440,18891,35900,125,139,16,931,45374,6779,16111.0,17103.0
948,"Lincoln County, Arkansas",8612,287,257,213,265,232,280,117,5,79,05079,1787,2524,2237,926,638,765,1442,1104,2425,3289,3679,2030,13455,8612,4843,8872,4106,0,279,529,46596,2628,3826.0,3870.0
949,"Crittenden County, Arkansas",23159,1942,1916,1156,1824,1856,1684,1149,5,35,05035,3792,4079,5667,2825,3940,4788,6478,3794,7732,8867,12145,6619,48672,23159,25513,21168,23352,337,195,1246,40161,6650,15952.0,16086.0
950,"Faulkner County, Arkansas",60393,3919,4096,2590,3721,4288,3609,2323,5,45,05045,13712,11924,13432,6529,14465,11950,14346,8529,28177,23874,27778,15058,123624,60393,63231,101450,14094,1641,2456,5060,52827,24425,47527.0,54264.0
951,"Walker County, Georgia",34210,2114,2286,1549,1758,2134,1869,1292,13,295,13295,4992,6245,9426,5471,4551,6332,9725,7168,9543,12577,19151,12639,69039,34210,34829,63519,2840,565,495,1531,46157,12640,23956.0,29436.0
952,"Gwinnett County, Georgia",446993,30991,34218,22865,30126,33446,36920,22175,13,135,13135,72497,93791,115991,38671,71121,100966,123860,49439,143618,194757,239851,88110,915046,446993,468053,443421,254466,106374,78987,193683,71026,188475,328331.0,412757.0
953,"Barrow County, Georgia",38740,2754,2917,1758,2707,3043,2769,1678,13,13,13013,6072,8502,9395,4223,5998,8560,9974,5522,12070,17062,19369,9745,78991,38740,40251,62276,9340,2928,2345,8613,62345,12919,29060.0,38017.0
954,"Charlton County, Georgia",7455,310,264,120,408,265,437,248,13,49,13049,1309,1694,2354,920,820,938,1449,1020,2129,2632,3803,1940,13040,7455,5585,8661,3419,96,230,1091,41961,1854,4016.0,4565.0
955,"Clinch County, Georgia",3380,302,186,207,156,269,236,52,13,65,13065,479,542,870,478,525,615,892,561,1004,1157,1762,1039,6686,3380,3306,4383,1900,0,251,280,27658,760,2455.0,2864.0
956,"Bartow County, Georgia",51825,3570,3881,2281,3290,3084,3889,2250,13,15,13015,8093,9990,14193,6417,8101,10215,14319,7946,16194,20205,28512,14363,104919,51825,53094,87869,10931,933,2299,9052,57423,17063,39550.0,50466.0
957,"Douglas County, Georgia",68291,4576,4648,3522,4420,5015,5484,3420,13,97,13097,11149,12916,18063,7092,11455,15654,20351,9226,22604,28570,38414,16318,143316,68291,75025,66197,67249,2324,3852,13848,63835,29095,57738.0,68745.0
958,"Grady County, Georgia",12073,653,934,527,718,624,1055,507,13,131,13131,1662,2109,3151,1913,1692,2204,3462,2493,3354,4313,6613,4406,24828,12073,12755,16251,7406,139,53,2846,43531,3522,9213.0,10689.0
959,"Hancock County, Georgia",4816,156,160,174,176,151,165,34,13,141,13141,1130,963,1187,878,434,482,1231,1026,1564,1445,2418,1904,8515,4816,3699,2080,6235,31,114,142,31860,979,3580.0,4165.0
960,"Whitfield County, Georgia",51688,3489,3910,2498,3462,4067,3645,2275,13,313,13313,8789,10107,12551,6339,8315,9877,12954,7954,17104,19984,25505,14293,104237,51688,52549,92420,4011,1536,3966,36599,48623,14832,30658.0,36746.0
961,"Macon County, Georgia",7262,264,362,226,315,392,271,312,13,193,13193,1422,1692,1876,1008,834,940,1786,1193,2256,2632,3662,2201,13305,7262,6043,4558,8178,52,393,571,32161,1318,4287.0,4662.0
962,"Troup County, Georgia",33401,2334,1968,1454,2228,2203,2684,1418,13,285,13285,5911,6190,8358,4215,6004,6801,9277,5903,11915,12991,17635,10118,69919,33401,36518,40778,25307,1586,830,2572,45649,9927,26111.0,29967.0
963,"Harris County, Georgia",17143,1001,1107,704,700,850,1199,790,13,145,13145,2385,2923,4982,2928,2029,2910,5249,3235,4414,5833,10231,6163,34105,17143,16962,27006,5495,364,211,1213,76319,6384,16502.0,20040.0
964,"Schley County, Georgia",2574,182,108,149,157,137,266,89,13,249,13249,503,462,630,386,404,486,657,451,907,948,1287,837,5221,2574,2647,3638,1328,0,196,340,44448,703,1909.0,2275.0
965,"Worth County, Georgia",9871,585,747,445,649,674,561,348,13,321,13321,1477,1712,2651,1647,1406,1794,2994,2197,2883,3506,5645,3844,20494,9871,10623,14049,5741,162,85,451,45398,3220,8295.0,9281.0
966,"Dooly County, Georgia",7433,270,307,236,278,238,470,257,13,93,13093,1239,1803,1999,1202,731,1092,1797,1440,1970,2895,3796,2642,13736,7433,6303,6194,6741,2,549,953,37340,1757,3859.0,4105.0
967,"Evans County, Georgia",5290,443,384,225,305,408,327,207,13,109,13109,718,968,1263,764,738,1047,1373,992,1456,2015,2636,1756,10687,5290,5397,6199,3175,97,1053,1253,42607,1599,3613.0,4247.0
968,"Webster County, Georgia",1272,13,81,82,46,89,111,42,13,307,13307,92,225,352,258,96,250,439,265,188,475,791,523,2610,1272,1338,1390,971,0,191,228,37297,392,1116.0,1390.0
969,"Effingham County, Georgia",29954,2194,2604,1402,1962,2183,2246,1434,13,103,13103,4505,6427,7629,3102,4329,6444,8124,3801,8834,12871,15753,6903,60477,29954,30523,49360,8050,534,725,2686,66822,11776,23458.0,31624.0
970,"Glascock County, Georgia",1461,103,126,33,22,83,69,114,13,125,13125,200,246,406,214,225,276,466,280,425,522,872,494,2996,1461,1535,2655,306,0,0,37,45000,554,1390.0,1566.0
971,"Quitman County, Georgia",1087,49,89,31,114,14,82,37,13,239,13239,102,254,279,245,95,194,341,325,197,448,620,570,2289,1087,1202,865,1188,168,0,17,26667,212,1044.0,1106.0
972,"Chatham County, Georgia",138879,9422,9132,4899,9083,8211,8433,4798,13,51,13051,28663,28201,31827,18627,28994,29352,36323,24423,57657,57553,68150,43050,288496,138879,149617,152025,115023,7428,4299,18472,56842,53570,112142.0,133289.0
973,"Johnson County, Georgia",5505,301,342,178,247,310,154,175,13,167,13167,850,1364,1488,822,557,668,1141,934,1407,2032,2629,1756,9691,5505,4186,6218,3214,21,26,239,42446,1606,3686.0,4100.0
974,"Lanier County, Georgia",5028,336,233,276,416,339,473,163,13,173,13173,892,1091,1191,628,761,1182,1212,806,1653,2273,2403,1434,10380,5028,5352,7683,2532,21,55,594,40986,1648,2871.0,3576.0
975,"Madison County, Georgia",14346,821,1229,536,869,1025,898,535,13,195,13195,2103,2611,4036,2192,1938,2841,4093,2673,4041,5452,8129,4865,29218,14346,14872,24637,3108,112,935,1595,52500,5649,11998.0,14707.0
976,"Mitchell County, Georgia",11535,689,753,288,602,632,740,586,13,205,13205,2019,2536,2940,1485,1419,1817,2819,2094,3438,4353,5759,3579,22244,11535,10709,10929,10342,44,200,1019,38116,2800,7880.0,8963.0
977,"Tift County, Georgia",19674,1601,1279,873,1225,1550,1235,772,13,277,13277,3641,3757,4541,2440,3659,3930,5077,3419,7300,7687,9618,5859,40541,19674,20867,26142,12007,559,1121,4776,45639,5770,14219.0,16284.0
978,"Polk County, Georgia",20607,1433,1483,968,1420,1554,1516,854,13,233,13233,3252,3834,5194,2834,3011,3981,5346,3619,6263,7815,10540,6453,41908,20607,21301,33219,5035,154,2174,5482,44891,6578,14215.0,17399.0
979,"Talbot County, Georgia",3051,154,167,116,127,118,173,87,13,263,13263,380,530,885,673,399,450,1106,810,779,980,1991,1483,6321,3051,3270,2606,3649,35,4,38,38549,911,3246.0,3519.0
980,"Terrell County, Georgia",4166,302,270,132,247,407,146,221,13,273,13273,698,731,1042,684,628,718,1249,955,1326,1449,2291,1639,8737,4166,4571,3164,5220,271,41,246,34768,901,4189.0,4417.0
981,"Thomas County, Georgia",21262,1453,1578,958,1363,1122,1751,887,13,275,13275,3049,3760,5635,3292,3259,4136,6290,4560,6308,7896,11925,7852,44630,21262,23368,26765,16240,74,414,1657,43740,7398,18802.0,21853.0
982,"Wilkinson County, Georgia",4273,232,278,160,268,254,352,199,13,319,13319,579,782,1201,714,584,787,1319,974,1163,1569,2520,1688,9010,4273,4737,5333,3509,0,35,259,38996,1441,4287.0,4770.0
983,"Oglethorpe County, Georgia",7559,476,632,298,384,435,418,215,13,221,13221,1031,1324,1978,1332,932,1331,2171,1486,1963,2655,4149,2818,14931,7559,7372,11909,2624,32,64,682,47120,2395,6674.0,8126.0
984,"Randolph County, Georgia",3378,177,373,137,228,389,150,129,13,243,13243,326,585,902,686,528,575,779,817,854,1160,1681,1503,6973,3378,3595,2422,4351,0,75,98,31699,608,2899.0,3074.0
985,"Ware County, Georgia",17921,1158,1484,672,1083,1104,1138,821,13,299,13299,3093,3432,4634,2513,2428,3012,4585,3501,5521,6444,9219,6014,35593,17921,17672,23071,10739,374,460,1461,36869,5380,12184.0,14296.0
986,"Wayne County, Georgia",14998,902,986,558,1077,1179,878,629,13,305,13305,2345,2958,3989,2104,1971,2738,3765,2553,4316,5696,7754,4657,29788,14998,14790,22251,6127,182,405,1866,45483,4951,10413.0,12790.0
987,"Wilcox County, Georgia",5286,229,291,127,233,224,222,103,13,315,13315,923,1461,1380,641,472,549,908,827,1395,2010,2288,1468,8824,5286,3538,5567,3131,0,51,411,36964,1546,2976.0,3281.0
988,"Baldwin County, Georgia",22815,1156,1293,685,1060,1261,1123,758,13,9,13009,5698,3748,5832,3234,5633,3352,5384,3725,11331,7100,11216,6959,45111,22815,22296,24245,19102,791,140,1019,43672,6902,16116.0,18251.0
989,"Bulloch County, Georgia",37316,2227,2051,1237,2097,1784,2405,1247,13,31,13031,12391,6173,7265,3804,11752,6647,8197,4675,24143,12820,15462,8479,76120,37316,38804,49581,21245,990,1138,3034,45550,11114,25316.0,30084.0
990,"Clay County, Georgia",1427,19,64,50,92,88,74,63,13,61,13061,199,247,399,335,188,182,410,427,387,429,809,762,2951,1427,1524,1056,1841,30,17,11,22325,274,1273.0,1434.0
991,"Echols County, Georgia",1888,64,101,64,111,214,111,140,13,101,13101,277,475,509,322,240,417,541,319,517,892,1050,641,3981,1888,2093,2939,79,0,698,1086,39494,729,1182.0,1441.0
992,"DeKalb County, Georgia",354278,26876,25008,13312,26091,23441,23400,13100,13,89,13089,61702,80703,86433,36626,67165,88215,100752,52881,128867,168918,187185,89507,749323,354278,395045,257388,404889,45447,12753,63947,62399,177322,314757.0,367359.0
993,"Haralson County, Georgia",14126,899,991,577,940,772,1279,609,13,143,13143,2104,2631,3938,1991,2101,2582,4201,2617,4205,5213,8139,4608,29227,14126,15101,26978,1481,120,109,498,48550,5514,11357.0,14272.0
994,"Jefferson County, Georgia",7522,497,511,335,453,418,626,335,13,163,13163,1199,1370,1928,1166,1084,1323,2217,1640,2283,2693,4145,2806,15618,7522,8096,6796,8325,49,244,600,33944,1686,6968.0,7652.0
995,"Lincoln County, Georgia",3675,180,186,24,220,237,277,164,13,181,13181,527,627,1076,836,482,613,1198,990,1009,1240,2274,1826,7856,3675,4181,5295,2433,0,47,143,39742,1300,4102.0,4643.0
996,"Murray County, Georgia",19683,1261,1430,945,1239,1510,1270,800,13,213,13213,3127,3569,5364,2531,2945,3820,5268,3189,6072,7389,10632,5720,39724,19683,20041,38443,413,135,292,5974,48033,6093,12458.0,15389.0
997,"Pulaski County, Georgia",5199,277,319,241,263,104,285,189,13,235,13235,959,700,1464,1002,871,1548,1530,1227,1830,2248,2994,2229,11216,5199,6017,6743,4252,30,25,351,45148,1728,3605.0,4059.0
998,"Rabun County, Georgia",8219,310,453,274,424,339,374,249,13,241,13241,1174,1207,2295,2174,941,1337,2365,2397,2115,2544,4660,4571,16645,8219,8426,15313,449,188,507,1334,42500,3382,7992.0,9587.0
999,"Towns County, Georgia",5464,191,170,154,195,187,189,130,13,281,13281,1074,567,1280,1805,1091,629,1541,2191,2165,1196,2821,3996,11617,5464,6153,11140,173,60,90,318,48219,2552,6764.0,7979.0
1000,"Treutlen County, Georgia",3495,267,118,168,142,283,192,76,13,283,13283,643,575,847,658,484,502,871,750,1127,1077,1718,1408,6795,3495,3300,4960,1792,0,19,90,32241,1226,2703.0,3077.0
1001,"Irwin County, Georgia",4904,238,302,202,185,273,298,193,13,155,13155,907,916,1182,796,583,807,1132,945,1490,1723,2314,1741,9320,4904,4416,6503,2674,38,50,357,37736,1553,3670.0,4171.0
1002,"Appling County, Georgia",9318,648,756,513,588,640,569,310,13,1,13001,1451,1595,2405,1397,1175,1599,2531,1710,2626,3194,4936,3107,18440,9318,9122,13750,3561,74,783,1830,40304,2559,7012.0,8341.0
1003,"Shelby County, Ohio",24594,1681,1816,1157,1507,1449,1803,1056,39,149,39149,3618,4254,6726,3555,3370,4200,6526,4244,6988,8454,13252,7799,48749,24594,24155,45876,1276,576,74,758,63806,9895,23740.0,24785.0
1004,"Williams County, Ohio",18267,1047,1197,767,1078,1053,1292,769,39,171,39171,2682,3402,5009,3007,2350,3110,5105,3792,5032,6512,10114,6799,36816,18267,18549,34946,404,214,436,1661,53183,7496,17308.0,18290.0
1005,"Columbiana County, Ohio",52098,2770,3329,1970,2556,2762,3130,1880,39,29,39029,7198,9661,15199,9181,6390,8263,14825,11286,13588,17924,30024,20467,103190,52098,51092,97715,2112,191,870,1833,48345,22877,46201.0,49169.0
1006,"Fulton County, Ohio",20888,1284,1330,967,1201,1301,1391,864,39,51,39051,2958,3569,5811,3269,2887,3724,5969,4028,5845,7293,11780,7297,42253,20888,21365,39307,169,182,1377,3689,63092,9010,21225.0,22299.0
1007,"Gallia County, Ohio",14826,972,984,619,950,870,988,536,39,53,39053,2212,2542,4063,2432,2085,2576,4123,3134,4297,5118,8186,5566,30088,14826,15262,28219,657,232,168,408,44858,6380,12931.0,13358.0
1008,"Mahoning County, Ohio",112279,6074,6362,4424,5932,6026,6430,4162,39,99,39099,17668,19379,31279,20109,16409,18809,33081,26833,34077,38188,64360,46942,229961,112279,117682,183221,34740,2042,1926,13804,46042,46930,115072.0,116565.0
1009,"Scioto County, Ohio",37322,2105,2344,1536,2279,2213,2268,1447,39,145,39145,6235,7129,9769,5806,5530,6851,10410,7720,11765,13980,20179,13526,76040,37322,38718,71545,2224,321,245,1030,41330,15605,30784.0,31146.0
1010,"Morrow County, Ohio",17570,907,1033,912,982,933,1276,750,39,117,39117,2283,3090,5307,2696,2240,3037,5142,3113,4523,6127,10449,5809,35043,17570,17473,33794,312,40,134,519,59452,7468,16548.0,18088.0
1011,"Marion County, Arkansas",7959,348,442,259,371,479,423,235,5,89,05089,845,1072,2387,2199,783,1163,2631,2432,1628,2235,5018,4631,16476,7959,8517,15820,80,147,18,379,36719,3410,7107.0,7481.0
1012,"Searcy County, Arkansas",3998,188,183,160,195,210,220,142,5,129,05129,461,573,1138,1001,484,574,1085,1000,945,1147,2223,2001,7908,3998,3910,7374,48,55,37,191,36438,1676,3728.0,4018.0
1013,"Benton County, Arkansas",131999,9686,10067,5875,9024,9485,10147,5758,5,7,05007,20416,29435,30266,15818,20130,28546,31217,19453,40546,57981,61483,35271,265759,131999,133760,232718,4541,10253,4865,44161,66362,56213,96824.0,119166.0
1014,"Hot Spring County, Arkansas",17484,937,972,700,694,1076,868,508,5,59,05059,2699,3462,4744,2831,2166,2927,4417,3457,4865,6389,9161,6288,33597,17484,16113,28434,3834,133,453,1176,43889,6453,11944.0,12503.0
1015,"Madison County, Arkansas",8034,502,538,369,610,421,570,360,5,87,05087,1097,1388,2261,1433,1007,1283,2298,1628,2104,2671,4559,3061,16211,8034,8177,15176,49,203,151,928,41682,3399,6841.0,7315.0
1016,"Dolores County, Colorado",1042,119,102,13,3,33,68,11,8,33,08033,35,211,246,257,76,127,241,256,111,338,487,513,1857,1042,815,1795,0,0,3,131,45972,486,1255.0,1431.0
1017,"Jackson County, Colorado",648,13,30,12,20,8,30,38,8,57,08057,87,64,229,179,70,123,146,178,157,187,375,357,1261,648,613,1234,0,0,22,220,53300,266,861.0,873.0
1018,"Montezuma County, Colorado",12874,692,752,513,685,906,625,511,8,83,08083,1592,1959,3707,2652,1437,2198,3842,2953,3029,4157,7549,5605,26031,12874,13157,21077,72,196,940,3260,49470,5345,12858.0,15421.0
1019,"Boulder County, Colorado",162211,7572,9026,5845,7223,8428,9270,5630,8,13,08013,37866,31450,40946,20054,33590,29859,42259,24040,71456,61309,83205,44094,322510,162211,160299,286950,2944,15281,5934,44740,83019,83225,188142.0,193709.0
1020,"Yuma County, Colorado",4977,370,410,221,356,304,484,172,8,125,08125,681,932,1232,785,634,803,1233,1040,1315,1735,2465,1825,10003,4977,5026,9587,112,5,87,2343,52022,1834,4791.0,4885.0
1021,"Routt County, Colorado",13044,534,667,505,566,697,573,465,8,107,08107,2083,3038,3729,1896,1704,2510,3745,1768,3787,5548,7474,3664,25072,13044,12028,24002,232,285,234,1743,77443,6807,13986.0,16767.0
1022,"Clear Creek County, Colorado",4778,156,119,83,219,166,168,278,8,19,08019,577,897,1677,953,540,726,1727,893,1117,1623,3404,1846,9495,4778,4717,8947,114,91,1,662,67060,2800,5866.0,6290.0
1023,"Pueblo County, Colorado",81738,4880,5131,3386,4724,4900,5442,3297,8,101,08101,13306,15102,20428,13636,12473,15100,21746,16562,25779,30202,42174,30198,165982,81738,84244,133497,3494,1489,13963,71356,46783,28532,78646.0,86761.0
1024,"Park County, Colorado",9515,352,336,270,355,346,396,232,8,93,08093,1114,1540,3544,1864,826,1282,3213,1702,1940,2822,6757,3566,17867,9515,8352,16856,56,123,123,1091,73622,4183,10417.0,12032.0
1025,"Mesa County, Colorado",74601,4409,4907,2796,4193,4249,5002,2722,8,77,08077,12233,14322,18452,12730,11812,13571,19719,15349,24045,27893,38171,28079,151218,74601,76617,142163,1020,1411,1628,21988,55379,30045,77653.0,85368.0
1026,"El Paso County, Colorado",352903,24071,23853,14367,23096,23385,22891,13818,8,41,08041,74307,72155,80769,38986,60557,68879,85320,48125,134864,141034,166089,87111,698974,352903,346071,556174,44801,19567,28546,119545,68779,133978,318967.0,375058.0
1027,"Arapahoe County, Colorado",318960,20570,21634,13336,19842,21068,21386,12734,8,5,08005,52852,71826,79493,36230,50187,70494,84008,45881,103039,142320,163501,82111,644560,318960,325600,461113,69853,38957,39870,123960,77469,143036,303046.0,346740.0
1028,"New Castle County, Delaware",269189,16456,16223,10815,15873,15493,17878,10308,10,3,10003,47171,52932,71511,36478,47122,54173,78339,47790,94293,107105,149850,84268,556165,269189,286976,357185,139960,30704,11877,55302,73892,129244,262391.0,286133.0
1029,"Kent County, Delaware",85199,5561,5323,3461,5481,5608,5602,3384,10,1,10001,15442,15173,20871,13027,15083,16584,23368,16390,30525,31757,44239,29417,176699,85199,91500,116954,45424,3552,2089,12485,60910,32882,74598.0,86958.0
1030,"Litchfield County, Connecticut",90109,3869,5081,3635,3584,4096,5119,3409,9,5,09005,12072,14203,29215,17137,10898,14254,30213,20320,22970,28457,59428,37457,182002,90109,91893,168841,3165,3438,2092,11436,79906,48522,97442.0,107541.0
1031,"Palm Beach County, Florida",710241,38467,39656,25574,36735,37547,39386,24361,12,99,12099,102397,126936,184067,153095,97707,127194,198907,192949,200104,254130,382974,346044,1465027,710241,754786,1077422,273384,39423,37551,327940,63299,313825,662332.0,772236.0
1032,"Miami-Dade County, Florida",1311459,80710,74134,47696,77270,72773,75274,45948,12,86,12086,216874,282975,350257,179355,209604,280047,375502,251551,426478,563022,725759,430906,2699428,1311459,1387969,2028500,469202,43152,107096,1848925,51347,532746,980204.0,1157930.0
1033,"Franklin County, Florida",6734,279,231,180,239,242,297,107,12,37,12037,1086,1455,1841,1339,547,780,1523,1342,1633,2235,3364,2681,11811,6734,5077,9555,1664,41,317,644,46643,2277,6015.0,6857.0
1034,"Hamilton County, Florida",8403,384,587,236,245,262,456,254,12,47,12047,1544,1990,2236,1118,726,930,1737,1313,2270,2920,3973,2431,14326,8403,5923,8805,4949,43,155,1351,38569,1978,5460.0,5832.0
1035,"Sumter County, Florida",62567,1275,978,701,1005,1095,1338,938,12,119,12119,4252,7412,12128,34061,2890,3999,14355,36857,7142,11411,26483,70918,125044,62567,62477,111290,8818,1105,1453,7178,57226,30906,76665.0,92600.0
1036,"Holmes County, Florida",10546,469,581,395,448,469,528,278,12,59,12059,1863,2051,2811,1750,1048,1445,2570,2100,2911,3496,5381,3850,19432,10546,8886,17237,1356,131,67,546,39102,3549,8514.0,9072.0
1037,"Lee County, Florida",361232,17640,18178,11719,16704,17102,18990,11278,12,71,12071,46532,57754,90650,98818,45676,57800,100335,108351,92208,115554,190985,207169,737468,361232,376236,622299,63282,11967,24959,157681,57832,157749,326420.0,392767.0
1038,"Collier County, Florida",182946,8551,8878,5865,8132,8288,9539,5627,12,21,12021,22443,27505,44392,55598,20080,26418,48824,61599,42523,53923,93216,117197,371453,182946,188507,329909,25404,4861,5739,103692,69653,81677,170789.0,208054.0
1039,"Pasco County, Florida",255248,13938,15042,9647,13336,14394,15111,9364,12,101,12101,33215,45261,68094,54085,32539,47774,72719,64117,65754,93035,140813,118202,524602,255248,269354,456080,30221,13580,8345,79843,52828,109486,241139.0,301338.0
1040,"Highlands County, Florida",50361,2524,2419,1481,2358,2166,2723,1493,12,55,12055,6127,6816,11343,17043,5370,7108,12492,19366,11497,13924,23835,36409,103437,50361,53076,83541,9987,1467,6079,20775,40942,21144,45686.0,52076.0
1041,"DeSoto County, Florida",20836,887,1156,711,974,895,1053,616,12,27,12027,3802,4544,4923,3896,2066,2574,3783,4106,5868,7118,8706,8002,36903,20836,16067,31079,4634,83,584,11649,35438,6690,10818.0,12645.0
1042,"Columbia County, Florida",36232,2082,2509,1269,2132,2101,2015,1268,12,23,12023,6424,6860,9326,5959,4409,5681,9298,6832,10833,12541,18624,12791,69968,36232,33736,53651,12653,744,854,4407,46494,11668,28707.0,33011.0
1043,"Putnam County, Florida",36255,2304,2404,1245,1876,1687,2625,1419,12,107,12107,4995,5570,9595,7992,4621,5685,10442,8642,9616,11255,20037,16634,73252,36255,36997,58814,11922,456,347,7319,37670,12414,33117.0,36384.0
1044,"Union County, Florida",9979,448,453,221,445,425,336,255,12,125,12125,1747,2554,2841,1376,735,924,1290,914,2482,3478,4131,2290,15303,9979,5324,11268,3359,93,191,862,44270,2305,5694.0,6247.0
1045,"Levy County, Florida",19718,1001,1438,693,1026,1126,1049,668,12,75,12075,2501,3052,5352,4735,2479,3212,6126,4999,4980,6264,11478,9734,40403,19718,20685,35391,3541,349,30,3388,37326,7807,19395.0,23140.0
1046,"Volusia County, Florida",261504,12678,13410,8700,12680,13165,12796,8133,12,127,12127,39815,42724,71464,59096,37037,42658,78047,70467,76852,85382,149511,129563,536487,261504,274983,436700,58584,9618,18291,74629,49494,106428,260869.0,307578.0
1047,"Madison County, Florida",9866,480,466,334,421,494,405,261,12,79,12079,1679,1982,2585,1739,1173,1397,2466,1977,2852,3379,5051,3716,18460,9866,8594,10713,7128,163,284,1018,37037,2954,8505.0,9380.0
1048,"Escambia County, Florida",155157,9700,9274,5298,9227,8364,9430,5160,12,33,12033,33286,27767,37930,22742,28297,27394,41295,29167,61583,55161,79225,51909,313491,155157,158334,213368,68733,9367,3827,17808,50915,51306,152469.0,170123.0
1049,"Okaloosa County, Florida",103422,6888,6209,3634,6575,5952,6254,3313,12,91,12091,19968,20630,25091,14576,15723,19150,25936,17469,35691,39780,51027,32045,203794,103422,100372,159371,20032,6188,7016,18873,63412,36712,100855.0,116485.0
1050,"Lumpkin County, Georgia",15737,811,762,523,598,1120,725,561,13,187,13187,4059,2466,3791,2494,3889,2614,4193,2965,7948,5080,7984,5459,32402,15737,16665,30546,672,267,367,1569,51790,5603,12425.0,15524.0
1051,"Miller County, Georgia",2806,184,208,144,147,118,220,124,13,201,13201,361,452,736,533,378,516,759,719,739,968,1495,1252,5787,2806,2981,3940,1765,0,0,25,44542,972,2544.0,2835.0
1052,"Oconee County, Georgia",18737,1077,1481,1038,969,1239,1778,925,13,219,13219,2339,3354,5092,2717,2191,3928,5368,2997,4530,7282,10460,5714,38132,18737,19395,33718,1993,1403,110,2017,90751,9448,20149.0,25165.0
1053,"Henry County, Georgia",107505,6616,8172,6117,6367,7859,8678,5839,13,151,13151,17374,19924,29072,11228,17722,24586,32452,14348,35096,44510,61524,25576,225356,107505,117851,107871,99006,7519,3003,15374,71288,46348,98766.0,122742.0
1054,"Long County, Georgia",9457,749,773,470,652,827,772,332,13,183,13183,1819,2135,2063,750,1549,1984,2177,942,3368,4119,4240,1692,18692,9457,9235,11937,4660,203,785,2108,54605,3325,4117.0,5656.0
1055,"Stephens County, Georgia",11981,934,781,247,763,796,748,844,13,257,13257,1981,1869,3268,2255,2165,2062,3565,2826,4146,3931,6833,5081,25750,11981,13769,21785,3064,172,310,896,47164,4717,9815.0,11885.0
1056,"Jeff Davis County, Georgia",7347,571,464,318,456,625,551,315,13,161,13161,1100,1410,1744,1030,1205,1482,1811,1244,2305,2892,3555,2274,15036,7347,7689,11601,2515,34,397,1822,36669,2078,5096.0,5774.0
1057,"Calhoun County, Georgia",3891,108,127,123,93,116,193,103,13,37,13037,709,1070,1088,406,310,443,664,552,1019,1513,1752,958,6365,3891,2474,2163,3851,37,213,302,34167,877,2025.0,2193.0
1058,"Bibb County, Georgia",71915,5254,5656,3199,5279,4812,5404,2961,13,21,13021,12730,12753,17768,9506,14224,14442,20433,13730,26954,27195,38201,23236,153200,71915,81285,61569,83405,3113,1441,4986,41334,23403,62596.0,70623.0
1059,"Marion County, Georgia",4031,211,269,215,211,420,211,144,13,197,13197,457,665,1253,821,556,739,1199,921,1013,1404,2452,1742,8432,4031,4401,5191,2602,77,387,614,44643,1195,3190.0,3624.0
1060,"Bleckley County, Georgia",6054,395,424,230,359,288,433,285,13,23,13023,1419,835,1476,963,1381,1185,1524,1298,2800,2020,3000,2261,12807,6054,6753,8955,3522,31,183,379,48174,2173,4974.0,5706.0
1061,"Franklin County, Georgia",11116,783,625,407,594,559,811,449,13,119,13119,1873,1775,3058,1843,1837,1842,3013,2545,3710,3617,6071,4388,22766,11116,11650,19429,2119,215,570,1044,42488,3964,8502.0,10786.0
1062,"Lamar County, Georgia",9111,610,450,444,474,367,593,312,13,171,13171,1767,1511,2292,1386,2048,1611,2415,1741,3815,3122,4707,3127,18672,9111,9561,12363,5489,90,138,458,44846,2893,7612.0,9045.0
1063,"Emanuel County, Georgia",11047,771,705,462,811,579,1034,429,13,107,13107,1891,2201,2675,1505,1650,2092,2851,2040,3541,4293,5526,3545,22533,11047,11486,14069,7636,82,235,1015,37453,3333,7860.0,9501.0
1064,"Jasper County, Georgia",6730,412,449,227,361,444,532,277,13,159,13159,932,1121,1967,1083,927,1261,2026,1358,1859,2382,3993,2441,13916,6730,7186,10496,2838,41,377,546,51250,2300,6045.0,7644.0
1065,"Liberty County, Georgia",31138,3207,2073,1098,3055,2166,2105,1059,13,179,13179,8740,5876,5293,2332,6884,5758,6134,3050,15624,11634,11427,5382,61349,31138,30211,28086,25265,1260,2058,7737,48007,7702,16143.0,21326.0
1066,"Seminole County, Georgia",3949,276,282,91,172,232,250,184,13,253,13253,546,627,1064,836,560,727,1183,1064,1106,1354,2247,1900,8321,3949,4372,5170,2760,65,48,267,33357,1388,3588.0,3877.0
1067,"Twiggs County, Georgia",4038,243,200,105,187,280,160,152,13,289,13289,515,706,1184,815,512,691,1222,987,1027,1397,2406,1802,8229,4038,4191,4589,3526,17,0,59,34879,1355,4059.0,4438.0
1068,"Taylor County, Georgia",3863,193,266,165,216,147,316,152,13,269,13269,593,485,1293,666,583,682,1242,915,1176,1167,2535,1581,8116,3863,4253,4682,3081,149,174,213,33832,1050,3408.0,3839.0
1069,"Toombs County, Georgia",12476,615,975,636,1291,867,1141,547,13,279,13279,1952,2325,3081,1799,2030,2644,3418,2558,3982,4969,6499,4357,26972,12476,14496,17156,6961,245,2152,3153,40175,4021,9138.0,10914.0
1070,"Preble County, Ohio",20388,1170,1186,930,1110,1151,1372,835,39,135,39135,2690,3523,5846,3520,2581,3599,5884,4173,5271,7122,11730,7693,41093,20388,20705,39820,215,182,51,368,58957,9253,20565.0,21437.0
1071,"Allen County, Ohio",52045,3354,3405,2104,2967,3019,3487,2150,39,3,39003,9461,9171,13296,7809,7411,8943,13215,9938,16872,18114,26511,17747,103175,52045,51130,85161,12230,871,1067,3221,53131,19269,45894.0,46362.0
1072,"Crawford County, Ohio",20562,1312,1240,822,1107,1141,1316,802,39,33,39033,2905,3409,5750,3722,2734,3599,5746,4814,5639,7008,11496,8536,41821,20562,21259,40391,426,220,123,700,44971,9386,19237.0,20222.0
1073,"Guernsey County, Ohio",19534,1239,1088,800,1088,1126,1146,780,39,59,39059,2888,3296,5411,3397,2679,3161,5541,4056,5567,6457,10952,7453,39111,19534,19577,37144,444,171,306,460,45917,7826,16557.0,17806.0
1074,"Mercer County, Ohio",20670,1483,1345,907,1422,1347,1466,833,39,107,39107,3001,3453,5515,3246,2703,3155,5460,3828,5704,6608,10975,7074,40884,20670,20214,39658,335,228,135,788,62952,8758,21726.0,23426.0
1075,"Clark County, Ohio",65237,4022,4296,2699,3934,3742,4451,2723,39,23,39023,9960,10721,17671,11317,10148,11555,18618,14318,20108,22276,36289,25635,134726,65237,69489,116999,10915,825,655,4627,50873,25557,61429.0,62870.0
1076,"Lorain County, Ohio",151471,8913,9327,6442,8499,9237,9405,6137,39,93,39093,22786,27131,42375,24104,21196,27308,43852,30565,43982,54439,86227,54669,307670,151471,156199,261580,26255,3578,3873,30628,58427,58650,140562.0,151988.0
1077,"Montgomery County, Ohio",255887,16823,16644,10428,15854,15283,16538,9896,39,113,39113,43368,46105,66303,39686,43338,48520,72316,54038,86706,94625,138619,93724,531670,255887,275783,386350,108397,11476,5335,15959,51542,100146,258301.0,262560.0
1078,"Warren County, Ohio",115491,6840,7600,5643,6375,7165,8865,5266,39,165,39165,16400,22919,32304,14350,13791,22105,32389,17685,30191,45024,64693,32035,229132,115491,113641,202506,7895,13183,1114,6321,87125,56947,117267.0,132391.0
1079,"Ashtabula County, Ohio",49211,2856,3198,1978,2646,2992,2953,1947,39,7,39007,7127,8690,14053,8202,6219,7876,14056,9930,13346,16566,28109,18132,97830,49211,48619,90804,3515,533,433,4134,46700,20351,40867.0,43253.0
1080,"Kay County, Oklahoma",22077,1529,1543,934,1432,1364,1663,898,40,71,40071,3374,3969,5327,3672,3155,3749,5366,4698,6529,7718,10693,8370,44402,22077,22325,34574,915,199,1361,3554,46809,7369,16803.0,17249.0
1081,"Craig County, Oklahoma",7352,376,471,291,421,436,474,257,40,35,40035,1138,1411,1975,1242,926,1097,1850,1577,2064,2508,3825,2819,14390,7352,7038,9425,451,119,104,533,43329,2521,5785.0,6032.0
1082,"Canadian County, Oklahoma",69761,4941,5029,3091,4639,5704,4765,2982,40,17,40017,10271,15986,16720,8140,10136,15461,17022,9985,20407,31447,33742,18125,140455,69761,70694,113820,3995,4168,4032,12629,72056,27224,55278.0,61940.0
1083,"Latimer County, Oklahoma",5260,297,310,242,291,248,340,181,40,77,40077,854,800,1311,1117,809,826,1323,1070,1663,1626,2634,2187,10348,5260,5088,6866,113,95,26,392,44214,1804,4056.0,4249.0
1084,"Texas County, Oklahoma",11095,964,775,512,800,850,823,439,40,139,40139,2106,2113,2712,1100,1518,1855,2245,1180,3624,3968,4957,2280,20805,11095,9710,13182,514,691,5269,9552,52282,2914,5780.0,5521.0
1085,"Pushmataha County, Oklahoma",5436,315,344,224,322,297,394,188,40,127,40127,672,879,1464,1153,720,872,1539,1360,1392,1751,3003,2513,11128,5436,5692,8170,84,41,33,440,37692,2142,4483.0,4739.0
1086,"Johnston County, Oklahoma",5452,322,380,223,350,387,357,201,40,69,40069,810,887,1456,977,812,927,1440,1138,1622,1814,2896,2115,11064,5452,5612,7947,207,10,120,599,41332,2153,4018.0,4251.0
1087,"Beaver County, Oklahoma",2703,155,170,121,159,223,191,135,40,7,40007,375,463,697,469,317,457,655,537,692,920,1352,1006,5377,2703,2674,4335,31,2,811,1281,52349,931,2243.0,2178.0
1088,"Hughes County, Oklahoma",7120,401,442,295,353,335,480,254,40,63,40063,1255,1533,1714,1087,849,994,1559,1428,2104,2527,3273,2515,13372,7120,6252,8960,761,18,47,749,39365,2261,4526.0,4857.0
1089,"Comanche County, Oklahoma",63105,4345,4202,2220,4202,3953,3855,2204,40,31,40031,15298,12846,13565,6730,10970,11878,13415,8180,26268,24724,26980,14910,121762,63105,58657,76207,20396,3109,3217,15954,52161,19851,32564.0,35631.0
1090,"Adair County, Oklahoma",11053,835,848,475,787,829,838,512,40,1,40001,1643,1998,2771,1607,1625,1962,2833,1781,3268,3960,5604,3388,22220,11053,11167,9360,36,178,556,1518,34695,2897,6513.0,7108.0
1091,"Stephens County, Oklahoma",21168,1326,1454,932,1249,1444,1446,901,40,137,40137,2935,3881,5574,3651,2939,3950,5835,4715,5874,7831,11409,8366,43647,21168,22479,35971,766,239,2002,3392,47214,8689,17904.0,19057.0
1092,"Carter County, Oklahoma",23642,1702,1738,1039,1592,1478,1768,1049,40,19,40019,3594,4521,5911,3344,3453,4517,6235,4585,7047,9038,12146,7929,48319,23642,24677,36059,3141,598,560,3520,51419,8835,18534.0,19479.0
1093,"Greer County, Oklahoma",3431,183,165,85,131,208,130,111,40,55,40055,621,829,926,444,293,380,596,581,914,1209,1522,1025,5861,3431,2430,4613,380,0,227,669,41488,1058,1896.0,1973.0
1094,"McIntosh County, Oklahoma",9749,512,578,433,510,504,560,316,40,91,40091,1111,1518,2680,2356,1165,1494,2818,2609,2276,3012,5498,4965,19725,9749,9976,13768,528,22,41,552,39084,3801,7963.0,8335.0
1095,"Murray County, Oklahoma",7021,461,446,338,373,376,511,247,40,99,40099,945,1208,1844,1276,850,1232,1938,1398,1795,2440,3782,2674,13946,7021,6925,10582,221,86,128,924,52478,2796,5528.0,5894.0
1096,"Ottawa County, Oklahoma",15456,1133,1068,688,1026,1085,1009,635,40,115,40115,2568,2564,3711,2519,2487,2679,3934,3143,5055,5243,7645,5662,31454,15456,15998,21248,351,232,673,1798,39872,4692,10690.0,11438.0
1097,"Wagoner County, Oklahoma",39025,2382,2737,1741,2387,2729,2708,1671,40,145,40145,5469,7675,10120,5910,5320,7920,10456,6742,10789,15595,20576,12652,78958,39025,39933,59476,2777,1148,1304,4895,62795,14513,31300.0,35338.0
1098,"Caddo County, Oklahoma",15363,1076,1066,653,942,935,1088,614,40,15,40015,2291,3315,3901,2070,1828,2273,3501,2698,4119,5588,7402,4768,29242,15363,13879,18618,668,79,904,3778,46592,5212,9348.0,9859.0
1099,"Muskogee County, Oklahoma",33515,2324,2496,1423,2256,2291,2337,1357,40,101,40101,5481,6230,8297,4922,5211,6553,8841,6375,10692,12783,17138,11297,68736,33515,35221,39748,7262,475,2183,4285,43078,11562,24216.0,25081.0
1100,"Bryan County, Oklahoma",22558,1606,1610,848,1410,1451,1652,989,40,13,40013,4040,4169,5255,3680,3939,4139,5795,4524,7979,8308,11050,8204,46457,22558,23899,34348,817,286,990,2773,44212,8514,13818.0,15976.0
1101,"Jackson County, Oregon",105742,6193,6359,3690,5718,6385,6062,3733,41,29,41029,15334,19055,26999,21443,15175,19533,29014,25212,30509,38588,56013,46655,216574,105742,110832,197752,1486,2837,3068,27778,53412,42606,109327.0,125184.0
1102,"Grant County, Oregon",3671,202,211,105,128,238,104,141,41,23,41023,349,538,1045,1064,340,524,1008,1035,689,1062,2053,2099,7189,3671,3518,6811,7,55,35,272,44712,1464,4340.0,4577.0
1103,"Clackamas County, Oregon",202194,11248,12473,8281,10770,11947,12732,8041,41,5,41005,28865,39194,55880,32725,26984,40099,58296,39400,55849,79293,114176,72125,410463,202194,208269,359191,3865,17543,8672,35666,80484,88894,214039.0,230116.0
1104,"Tillamook County, Oregon",13237,655,852,399,567,679,850,336,41,57,41057,1672,2138,3729,3097,1349,2061,3847,3463,3021,4199,7576,6560,26389,13237,13152,24561,110,181,262,2727,49895,5374,13803.0,16725.0
1105,"Josephine County, Oregon",42293,2184,2406,1666,2062,2361,2305,1283,41,33,41033,5215,6758,11168,10268,4868,6632,12570,11877,10083,13390,23738,22145,86251,42293,43958,79658,442,866,1128,6408,45616,15432,44560.0,50205.0
1106,"Umatilla County, Oregon",40155,2631,2722,1661,2555,2660,2859,1638,41,59,41059,7173,8032,9547,5497,5396,6690,8853,6323,12569,14722,18400,11820,77129,40155,36974,66148,740,800,3677,20665,54699,11598,27597.0,32539.0
1107,"Columbia County, Oregon",25820,1420,1868,1086,1280,1616,1350,1063,41,9,41009,3515,4571,7478,4563,3035,4637,7743,4831,6550,9208,15221,9394,51375,25820,25555,47618,248,509,324,2652,62257,9898,26618.0,31518.0
1108,"Wasco County, Oregon",13122,890,728,521,764,905,717,395,41,65,41065,1931,2386,3245,2473,1773,2278,3376,2800,3704,4664,6621,5273,26130,13122,13008,23029,80,238,976,4755,53105,4186,11964.0,13904.0
1109,"Montgomery County, Georgia",4642,248,225,182,254,198,240,231,13,209,13209,908,836,1273,677,714,778,1176,825,1622,1614,2449,1502,9058,4642,4416,6053,2392,16,477,597,41996,1344,3576.0,3962.0
1110,"Rockdale County, Georgia",42245,2630,3164,2099,2599,2880,3437,2179,13,247,13247,6923,7183,11366,5506,6878,8908,13520,7071,13801,16091,24886,12577,89717,42245,47472,34832,49114,1775,1599,9173,60189,16994,37869.0,44617.0
1111,"Wheeler County, Georgia",5012,132,147,200,119,177,103,130,13,309,13309,1741,816,1108,532,429,377,996,585,2170,1193,2104,1117,7928,5012,2916,4465,3440,0,0,11,30192,1851,2102.0,2286.0
1112,"Banks County, Georgia",9400,486,593,495,524,522,589,396,13,11,13011,1264,1653,2760,1407,1226,1822,2557,1672,2490,3475,5317,3079,18708,9400,9308,17392,486,210,322,1289,47811,3409,6975.0,8813.0
1113,"Clarke County, Georgia",60045,3433,3147,1581,3273,2803,3154,1476,13,59,13059,21421,11448,10500,5483,23811,11818,11928,7868,45232,23266,22428,13351,126176,60045,66131,79862,35215,4891,2636,13626,38623,22769,44976.0,51218.0
1114,"Glynn County, Georgia",39757,2460,3013,1637,2464,2276,2959,1603,13,127,13127,5854,6977,10204,7314,6027,7956,12130,9298,11881,14933,22334,16612,84470,39757,44713,57857,22235,1099,811,5589,52977,15714,34263.0,41984.0
1115,"Jackson County, Georgia",33636,2349,2690,1416,2100,2342,2463,1552,13,157,13157,4671,6768,8998,4397,4617,6936,8857,5382,9288,13704,17855,9779,67885,33636,34249,58699,4625,1211,1566,5198,65385,12345,27190.0,37670.0
1116,"Jones County, Georgia",13728,689,1035,622,770,1212,787,654,13,169,13169,1984,2470,3803,2201,1883,2687,4092,2766,3867,5157,7895,4967,28579,13728,14851,20836,7043,213,9,476,56020,5606,12551.0,14966.0
1117,"Muscogee County, Georgia",95539,7264,6713,3876,6917,6608,6447,3617,13,215,13215,19439,19425,21483,10292,17365,20048,24045,15153,36804,39473,45528,25445,195739,95539,100200,84841,90580,4840,5341,14903,46408,29756,69032.0,80516.0
1118,"Stewart County, Georgia",4187,35,96,119,124,96,23,99,13,259,13259,1180,1332,843,405,288,318,626,532,1468,1650,1469,937,6293,4187,2106,1483,3328,203,1174,1180,29732,715,2058.0,1990.0
1119,"Turner County, Georgia",3801,223,267,144,308,207,338,177,13,287,13287,492,790,979,636,449,815,937,911,941,1605,1916,1547,7943,3801,4142,4550,3241,61,79,379,37039,938,3398.0,3792.0
1120,"Atkinson County, Georgia",4179,311,371,142,215,287,311,238,13,3,13003,685,854,962,506,643,753,1002,611,1328,1607,1964,1117,8239,4179,4060,6196,1444,0,508,2050,37197,1143,2610.0,3155.0
1121,"Baker County, Georgia",1530,44,121,70,57,87,79,93,13,7,13007,216,295,386,293,155,222,459,450,371,517,845,743,3132,1530,1602,1710,1244,96,45,172,32917,495,1440.0,1555.0
1122,"Candler County, Georgia",5339,314,413,187,255,502,354,179,13,43,13043,790,879,1393,858,819,959,1373,1032,1609,1838,2766,1890,10812,5339,5473,7242,2743,185,392,1273,33736,1377,3763.0,4420.0
1123,"Carroll County, Georgia",57024,3870,3721,2449,3531,3486,4067,2580,13,45,13045,11439,10846,13603,6788,12013,11077,14543,8862,23452,21923,28146,15650,117183,57024,60159,87519,22664,904,2908,8075,53737,18962,44121.0,54474.0
1124,"Crisp County, Georgia",10958,833,744,565,612,965,515,436,13,81,13081,1605,1856,2689,1820,1651,2141,3118,2317,3256,3997,5807,4137,22713,10958,11755,11973,10344,43,70,782,36042,2946,7512.0,8052.0
1125,"Cobb County, Georgia",363539,24015,25444,15921,23286,25153,24928,15542,13,67,13067,61622,77552,94586,38859,61322,83445,103822,50181,122944,160997,198408,89040,751218,363539,387679,440462,207059,40271,38088,97481,77932,186291,330819.0,392614.0
1126,"Dade County, Georgia",7913,426,333,274,350,409,456,248,13,83,13083,1425,1404,2116,1341,1479,1381,2234,1727,2904,2785,4350,3068,16197,7913,8284,15318,134,285,63,370,42581,2929,6242.0,7434.0
1127,"Brooks County, Georgia",7612,568,489,304,415,419,554,242,13,27,13027,1140,1293,2068,1286,1064,1353,2273,1658,2204,2646,4341,2944,15590,7612,7978,9298,5604,66,415,920,38285,2599,6336.0,7100.0
1128,"Elbert County, Georgia",9205,572,470,415,571,583,627,278,13,105,13105,1393,1550,2451,1681,1344,1602,2753,2203,2737,3152,5204,3884,19166,9205,9961,13059,5727,109,107,1093,38678,2933,7987.0,9171.0
1129,"Jenkins County, Georgia",4094,429,381,38,157,397,149,170,13,165,13165,695,571,1180,553,676,621,1515,1014,1371,1192,2695,1567,8793,4094,4699,5207,3070,98,214,718,27375,1213,3056.0,3455.0
1130,"Newton County, Georgia",51233,3560,4178,2821,3360,3855,4110,2610,13,217,13217,8505,9322,12925,5887,8669,11338,15104,7800,17174,20660,28029,13687,108079,51233,56846,54442,48483,1205,984,6035,56316,17503,43987.0,54224.0
1131,"Colquitt County, Georgia",22504,1590,1982,1079,1529,1341,1953,864,13,71,13071,3641,4356,5289,2994,3335,4346,5671,3943,6976,8702,10960,6937,45486,22504,22982,29029,10622,380,4232,8737,36435,6284,13624.0,16080.0
1132,"Clayton County, Georgia",132756,10873,10888,6342,10754,10976,11198,6551,13,63,13063,25057,26211,30719,10726,26814,31935,37710,14844,51871,58146,68429,25570,283538,132756,150782,46348,196495,14592,16789,37475,47864,37943,92859.0,111077.0
1133,"Hall County, Georgia",98831,6691,7345,4637,6410,6393,7506,4390,13,139,13139,16073,18825,24776,12930,15403,18716,25036,15982,31476,37541,49812,28912,198667,98831,99836,170110,14345,3538,6010,56409,62984,33488,70694.0,90424.0
1134,"Maui County, Hawaii",82633,5169,5385,2994,4738,5338,4514,3072,15,9,15009,10660,16724,22843,13650,10639,16582,23018,15445,21299,33306,45861,29095,165979,82633,83346,58891,845,48579,2865,18812,80948,29422,51945.0,71025.0
1135,"Oneida County, Idaho",2146,123,161,105,149,252,187,107,16,71,16071,253,348,539,397,236,341,523,444,489,689,1062,841,4385,2146,2239,4293,5,0,0,197,53841,710,2068.0,2451.0
1136,"Gem County, Idaho",8616,517,403,359,460,417,675,391,16,45,16045,1221,1177,2316,1829,1059,1274,2590,1849,2280,2451,4906,3678,17331,8616,8715,15611,20,98,878,1451,45492,3252,7954.0,9958.0
1137,"Adams County, Idaho",2112,74,119,73,79,92,117,54,16,3,16003,190,263,641,659,188,247,658,550,378,510,1299,1209,4097,2112,1985,3911,16,0,10,147,48856,915,2183.0,2586.0
1138,"Jerome County, Idaho",11982,1044,1025,383,986,943,1150,686,16,53,16053,1879,2417,2685,1457,1698,2141,2611,1533,3577,4558,5296,2990,23730,11982,11748,22161,41,227,613,8565,52921,3792,6751.0,7812.0
1139,"Lewis County, Idaho",1900,104,143,82,105,106,132,64,16,61,16061,207,255,522,455,207,277,555,492,414,532,1077,947,3838,1900,1938,3327,5,53,25,175,41198,687,1590.0,1870.0
1140,"Owyhee County, Idaho",5952,422,424,313,338,456,396,243,16,73,16073,842,1002,1494,1025,800,927,1391,1049,1642,1929,2885,2074,11552,5952,5600,9139,61,13,1572,3031,43798,1500,3925.0,4742.0
1141,"Boundary County, Idaho",5921,444,430,251,303,377,387,278,16,21,16021,720,885,1605,1263,704,934,1685,1256,1424,1819,3290,2519,11845,5921,5924,11145,63,144,80,590,43423,2445,5163.0,6313.0
1142,"Caribou County, Idaho",3570,237,336,208,229,275,292,174,16,29,16029,438,658,870,535,379,638,773,623,817,1296,1643,1158,6953,3570,3383,6636,0,4,139,405,59053,1143,3035.0,3416.0
1143,"Bannock County, Idaho",42727,3133,3163,1996,3087,3024,3118,1807,16,5,16005,8009,8492,9175,5498,7602,8385,9696,6319,15611,16877,18871,11817,85765,42727,43038,76327,603,1688,1683,7381,51734,15534,33416.0,39771.0
1144,"Bonneville County, Idaho",57322,5113,5383,2909,4600,4760,5010,2725,16,19,16019,8678,11423,12077,6868,8794,11097,12017,8067,17472,22520,24094,14935,114392,57322,57070,102331,583,1169,6523,14916,60615,18318,44221.0,53995.0
1145,"Canyon County, Idaho",107672,8186,8712,5351,8221,8621,9006,5085,16,27,16027,17991,20747,23656,13420,17637,21133,24449,15809,35628,41880,48105,29229,217633,107672,109961,180081,893,1846,23539,55034,52134,32867,72785.0,90438.0
1146,"Latah County, Idaho",20254,1002,1049,582,1015,957,1031,615,16,57,16057,6980,3080,3928,2503,6028,2923,4036,2646,13008,6003,7964,5149,39505,20254,19251,36325,462,915,212,1726,49158,7613,18173.0,20521.0
1147,"Sangamon County, Illinois",94496,5841,6381,4016,5544,6110,6114,3840,17,167,17167,14018,17752,25749,14398,14470,18874,27865,19548,28488,36626,53614,33946,196861,94496,102365,161188,25303,4006,840,4532,61912,41177,98373.0,104395.0
1148,"Randolph County, Illinois",17877,822,949,619,778,737,842,516,17,157,17157,3042,3806,5046,2641,1741,2608,3866,3330,4783,6414,8912,5971,32295,17877,14418,28031,3252,190,289,1014,53816,6193,14194.0,14896.0
1149,"Ogle County, Illinois",25310,1447,1555,1111,1298,1492,1761,1102,17,141,17141,3453,4476,7238,4236,3272,4522,7228,5040,6725,8998,14466,9276,51025,25310,25715,48105,520,276,1113,5166,60986,10049,24193.0,26040.0
1150,"Morgan County, Illinois",17174,898,910,553,894,1046,793,503,17,137,17137,3324,3236,4437,2925,2819,2768,4472,3778,6143,6004,8909,6703,34247,17174,17073,30809,2398,234,52,849,51437,7298,14800.0,15229.0
1151,"White County, Illinois",6785,415,449,252,365,446,402,278,17,193,17193,906,1161,1891,1324,840,1156,1927,1669,1746,2317,3818,2993,13868,6785,7083,13527,97,106,18,202,49290,2777,7335.0,7428.0
1152,"Henderson County, Illinois",3356,170,105,117,158,177,161,117,17,71,17071,409,478,1037,787,400,473,1066,901,809,951,2103,1688,6809,3356,3453,6647,9,39,0,123,53676,1642,3518.0,3652.0
1153,"McLean County, Illinois",83872,5099,5479,3282,5182,5493,4774,3006,17,113,17113,20056,15894,19322,9704,21784,15777,20445,12245,41840,31671,39767,21949,172578,83872,88706,143728,14423,8797,1170,8495,67675,39372,79835.0,87013.0
1154,"Perry County, Illinois",11627,473,429,388,602,557,531,321,17,145,17145,2060,2592,3229,1718,1166,1657,2584,2206,3226,4249,5813,3924,21251,11627,9624,18779,1925,146,64,662,52428,3958,9853.0,10060.0
1155,"Rock Island County, Illinois",70898,4641,4297,2724,4346,4329,4454,2562,17,161,17161,10905,13345,18298,11907,10730,12582,18829,15143,21635,25927,37127,27050,143873,70898,72975,115405,14968,3650,3941,18491,54858,26448,63994.0,66750.0
1156,"Wabash County, Illinois",5666,383,349,208,336,281,438,185,17,185,17185,778,953,1560,1049,727,988,1638,1287,1505,1941,3198,2336,11546,5666,5880,11062,76,112,39,308,50770,1915,5464.0,5592.0
1157,"Cumberland County, Illinois",5476,362,337,203,322,284,368,190,17,35,17035,668,1013,1517,961,673,922,1468,1133,1341,1935,2985,2094,10836,5476,5360,10544,8,46,53,116,56206,2276,5567.0,5843.0
1158,"Jo Daviess County, Illinois",10864,461,624,462,457,496,620,347,17,85,17085,1181,1659,3009,2809,1073,1581,3086,3064,2254,3240,6095,5873,21588,10864,10724,20973,123,134,60,654,57946,4992,11334.0,12477.0
1159,"Lawrence County, Illinois",8687,386,371,247,397,392,412,226,17,101,17101,1611,1990,2327,1292,842,1327,2037,1713,2453,3317,4364,3005,16033,8687,7346,14073,1331,87,71,615,46636,3118,6094.0,6379.0
1160,"Marshall County, Illinois",5788,348,286,228,303,224,407,222,17,123,17123,764,930,1670,1185,712,888,1659,1476,1476,1818,3329,2661,11679,5788,5891,11336,34,44,64,352,58465,2494,5984.0,6343.0
1161,"Christian County, Illinois",16644,845,1006,629,884,967,905,558,17,21,17021,2387,3248,4810,2767,2070,2779,4517,3607,4457,6027,9327,6374,32931,16644,16287,31774,436,208,2,535,52834,7054,15459.0,16094.0
1162,"Jackson County, Illinois",28661,1567,1355,838,1562,1189,1629,1080,17,77,17077,8869,4748,6112,3746,8178,4514,6313,4851,17047,9262,12425,8597,57977,28661,29316,44208,8723,1996,1085,2567,37241,11048,24617.0,22575.0
1163,"Peoria County, Illinois",88617,6517,5904,3515,6170,5925,5660,3457,17,143,17143,14475,17009,21817,13043,14905,17298,23712,17026,29380,34307,45529,30069,182770,88617,94153,132888,32480,7537,2670,8787,55842,35520,78503.0,82264.0
1164,"Piatt County, Illinois",8076,466,504,341,517,529,466,320,17,147,17147,1009,1474,2284,1445,967,1476,2361,1689,1976,2950,4645,3134,16401,8076,8325,15914,91,88,39,222,70849,3817,9008.0,9791.0
1165,"Stark County, Illinois",2691,133,173,114,159,157,160,129,17,175,17175,346,464,770,542,331,401,769,650,677,865,1539,1192,5447,2691,2756,5290,53,51,3,95,54907,1233,2743.0,2881.0
1166,"Bond County, Illinois",8582,343,560,304,346,360,510,289,17,5,17005,1427,1804,2357,1338,1232,1381,2196,1693,2659,3185,4553,3031,16589,8582,8007,15077,1264,59,56,584,57289,3550,7530.0,8109.0
1167,"Carroll County, Illinois",7178,364,340,278,406,333,464,230,17,15,17015,901,1149,2045,1711,818,1076,2074,1887,1719,2225,4119,3598,14466,7178,7288,13883,179,111,59,535,52410,3126,7445.0,8006.0
1168,"Jersey County, Illinois",10720,517,536,486,526,598,630,412,17,83,17083,1588,1790,3054,1897,1709,1812,3242,2288,3297,3602,6296,4185,21937,10720,11217,21211,96,67,17,309,63028,4644,10991.0,11942.0
1169,"Howard County, Maryland",155961,9758,11212,7413,9180,10534,11221,7040,24,27,24027,22667,31105,42984,19233,21516,33948,45933,23522,44183,65053,88917,42755,318855,155961,162894,181711,60232,57613,4209,22012,121160,101366,162193.0,172813.0
1170,"Prince George's County, Maryland",437440,30585,28961,16309,29327,28096,26565,15623,24,33,24033,80106,92209,113093,48606,77853,94940,130610,68216,157959,187149,243703,116822,908670,437440,471230,150782,569478,37453,120308,167498,84920,192883,390385.0,365857.0
1171,"Anne Arundel County, Maryland",282621,17845,18286,10580,17334,16724,18347,10428,24,3,24003,48076,58065,74969,36615,41557,58480,80118,45666,89633,116545,155087,82281,571275,282621,288654,415470,95710,21605,13578,44621,100798,135882,270081.0,249413.0
1172,"Baltimore County, Maryland",392496,24888,25800,15584,24101,24547,24441,14643,24,5,24005,64515,74691,103731,58367,66936,82586,117379,80889,131451,157277,221110,139256,828018,392496,435522,501423,239308,49885,11104,44807,76866,199419,390682.0,302247.0
1173,"Frederick County, Maryland",123912,7522,8244,5440,7273,7345,8823,5294,24,21,24021,18789,24280,35088,15746,18035,24697,36321,19722,36824,48977,71409,35468,251422,123912,127510,202622,24411,11192,3896,24101,97730,60278,125677.0,126818.0
1174,"Calvert County, Maryland",45538,2558,2751,2158,2278,2535,3379,2126,24,9,24009,6730,7755,13928,6121,6058,8268,14198,7131,12788,16023,28126,13252,91511,45538,45973,74326,10709,1718,531,3641,109313,19992,47408.0,47463.0
1175,"Garrett County, Maryland",14478,712,768,610,711,833,641,468,24,23,24023,2095,2324,4225,2986,1854,2390,4410,3450,3949,4714,8635,6436,29235,14478,14757,28327,250,125,33,330,52617,7439,14011.0,15045.0
1176,"Kent County, Maryland",9294,411,491,253,368,432,455,284,24,29,24029,1673,1339,2410,2329,1781,1329,2802,2791,3454,2668,5212,5120,19536,9294,10242,15774,2787,228,266,859,58598,4798,10021.0,9729.0
1177,"Montgomery County, Maryland",504128,33583,34584,21024,32434,33178,33024,20557,24,31,24031,73316,103710,134920,67793,72000,110125,149052,89032,145316,213835,283972,156825,1043530,504128,539402,553846,192639,154340,93555,203754,108820,312081,478873.0,345549.0
1178,"Bethel Census Area, Alaska",9477,941,883,555,894,881,864,448,2,50,02050,1786,1712,2033,639,1686,1578,1644,662,3472,3290,3677,1301,18134,9477,8657,2022,135,195,45,471,53553,1093,,
1179,"North Slope Borough, Alaska",5985,409,386,229,384,357,304,162,2,185,02185,823,1396,2024,386,630,768,917,285,1453,2164,2941,671,9792,5985,3807,3077,151,534,72,199,79306,1712,,
1180,"Sitka City and Borough, Alaska",4444,185,327,202,198,254,256,122,2,220,02220,668,894,1207,628,620,919,1145,682,1288,1813,2352,1310,8640,4444,4196,5554,80,579,68,584,73682,1921,,
1181,"Fairbanks North Star Borough, Alaska",53417,4056,3212,1594,3752,3676,2600,1699,2,90,02090,14150,10966,11142,4943,9298,9448,10426,4756,23448,20414,21568,9699,99072,53417,45655,74722,4412,3207,1106,7972,76992,18264,,
1182,"Ketchikan Gateway Borough, Alaska",7083,411,396,296,386,467,393,246,2,130,02130,1136,1351,2044,1011,945,1302,1939,1039,2081,2653,3983,2050,13800,7083,6717,9178,104,1134,151,727,72728,2646,,
1183,"Matanuska-Susitna Borough, Alaska",54838,3846,3923,2463,3671,3961,3823,2263,2,170,02170,8814,11203,14134,6009,7396,10437,13050,5930,16210,21640,27184,11939,105369,54838,50531,87323,1299,1453,396,5198,75493,18969,,
1184,"Nome Census Area, Alaska",5262,498,540,256,489,457,466,237,2,180,02180,1004,965,1157,351,849,882,995,351,1853,1847,2152,702,9988,5262,4726,1555,95,166,12,274,61048,643,,
1185,"Dillingham Census Area, Alaska",2542,199,218,122,270,194,220,116,2,70,02070,475,483,550,290,443,437,530,209,918,920,1080,499,4961,2542,2419,866,79,67,31,184,56898,411,,
1186,"Yakutat City and Borough, Alaska",356,30,16,3,26,23,26,11,2,282,02282,62,75,101,54,50,47,70,40,112,122,171,94,649,356,293,293,5,32,6,50,71607,97,,
1187,"Lake and Peninsula Borough, Alaska",749,39,39,25,48,49,51,32,2,164,02164,140,199,219,48,132,109,162,61,272,308,381,109,1393,749,644,293,16,23,1,2,44135,127,,
1188,"Southeast Fairbanks Census Area, Alaska",3770,244,281,152,273,254,282,126,2,240,02240,571,688,1055,527,430,558,774,411,1001,1246,1829,938,6878,3770,3108,5257,45,183,145,417,70056,1140,,
1189,"Anchorage Municipality, Alaska",149670,10762,10628,6004,10435,10152,8901,5438,2,20,02020,30567,31751,35892,14510,25991,30731,35850,16363,56558,62482,71742,30873,293531,149670,143861,183741,16341,28276,6910,26927,84928,56001,7140.0,
1190,"Aleutians East Borough, Alaska",2033,59,81,41,50,43,73,51,2,13,02013,405,473,735,153,146,286,538,165,551,759,1273,318,3385,2033,1352,510,142,666,142,305,69250,295,6533.0,
1191,"Valdez-Cordova Census Area, Alaska",4845,283,311,205,301,372,277,104,2,261,02261,702,947,1483,611,599,925,1297,523,1301,1872,2780,1134,9243,4845,4398,6633,35,376,196,484,79867,1805,,
1192,"Kenai Peninsula Borough, Alaska",30480,1805,1929,1184,1787,1650,1931,1086,2,122,02122,4490,5626,8533,5038,3694,5067,8176,4593,8184,10693,16709,9631,58464,30480,27984,48218,365,924,849,2428,66064,11685,,
1193,"Skagway Municipality, Alaska",606,16,20,13,45,20,11,18,2,230,02230,121,167,186,67,55,131,158,63,176,298,344,130,1107,606,501,940,44,9,4,63,73906,255,,
1194,"Prince of Wales-Hyder Census Area, Alaska",3478,193,233,129,187,193,225,108,2,198,02198,456,570,1078,586,385,508,882,441,841,1078,1960,1027,6407,3478,2929,3056,29,91,21,247,52379,948,,
1195,"Petersburg Borough, Alaska",1723,119,95,67,90,84,94,40,2,195,02195,386,211,425,360,196,251,422,357,582,462,847,717,3257,1723,1534,2480,33,153,12,381,69948,636,,
1196,"Kusilvak Census Area, Alaska",4463,561,487,237,515,381,454,227,2,158,02158,880,735,892,203,746,582,631,251,1626,1317,1523,454,8250,4463,3787,297,40,11,44,93,36754,290,,
1197,"Maricopa County, Arizona",2140563,142527,145200,91031,135982,141628,147396,87241,4,13,04013,373746,436326,507408,289269,356865,432099,534491,352545,730611,868425,1041899,641814,4328810,2140563,2188247,3360305,243640,181352,288830,1341560,64468,804626,1567834.0,1991563.0
1198,"Graham County, Arizona",20325,1423,1293,872,1342,1319,1504,896,4,9,04009,4006,4430,4229,2438,2990,3108,3748,2764,6996,7538,7977,5202,37996,20325,17671,30366,744,240,701,12543,51353,5006,20306.0,15026.0
1199,"Santa Cruz County, Arizona",22271,1611,1831,1114,1700,1833,1728,1176,4,23,04023,3638,3524,5148,3688,3429,4045,5949,4349,7067,7569,11097,8037,46480,22271,24209,39840,301,424,4931,38793,41259,6434,16433.0,19546.0
1200,"La Paz County, Arizona",10708,504,606,347,458,395,475,197,4,12,04012,1170,1288,2190,4190,1091,1243,2391,3835,2261,2531,4581,8025,20793,10708,10085,16035,200,151,706,5735,34643,3227,5951.0,6677.0
1201,"Mohave County, Arizona",104944,4817,4997,3264,4292,4671,5635,3181,4,15,04015,12788,15312,27671,30586,11109,13755,29311,30797,23897,29067,56982,61383,207695,104944,102751,187413,2217,2314,5325,34160,45587,37333,79943.0,103836.0
1202,"Coconino County, Arizona",69789,4004,3803,2664,3758,3666,4247,2405,4,5,04005,18980,12283,15186,8112,20827,11614,16097,8871,39807,23897,31283,16983,141274,69789,71485,90333,1742,2766,3584,19931,59460,22671,59784.0,72110.0
1203,"Yavapai County, Arizona",111450,5006,5448,3484,4583,5097,5406,3304,4,25,04025,13720,15153,29882,33356,12060,15061,34604,36502,25780,30214,64486,69858,228067,111450,116617,208248,1495,2205,6102,33166,52451,45132,114450.0,141719.0
1204,"Greenlee County, Arizona",4984,340,325,362,409,350,373,49,4,11,04011,842,1066,1082,547,771,928,1027,631,1613,1994,2109,1178,9522,4984,4538,8715,209,52,126,4456,63473,1702,5192.0,3692.0
1205,"Pinal County, Arizona",225618,12650,13934,8448,12274,14569,13823,8102,4,21,04021,35771,47739,50034,41454,26240,38295,49352,44520,62011,86034,99386,85974,432793,225618,207175,345754,18915,7139,19648,130511,58174,70968,129546.0,156460.0
1206,"Nevada County, Arkansas",4237,312,281,213,191,235,252,112,5,99,05099,569,616,1171,771,460,709,1233,922,1029,1325,2404,1693,8351,4237,4114,5247,2884,3,0,2,38042,1480,3246.0,3358.0
1207,"Cross County, Arkansas",8094,522,527,323,544,508,578,358,5,37,05037,1175,1427,2155,1346,1168,1572,2264,1738,2343,2999,4419,3084,16824,8094,8730,12380,3141,5,7,167,46787,3020,6874.0,6911.0
1208,"Dallas County, Arkansas",3589,176,179,173,202,105,152,270,5,39,05039,472,597,989,696,451,593,996,921,923,1190,1985,1617,7279,3589,3690,3888,3148,4,70,98,38072,915,2771.0,2649.0
1209,"Columbia County, Arkansas",11407,758,749,488,687,660,661,378,5,27,05027,2705,1709,2629,1739,2816,2004,2837,2326,5521,3713,5466,4065,23776,11407,12369,14396,8592,254,243,645,36193,3790,8887.0,8550.0
1210,"Saline County, Arkansas",58571,3527,4336,2630,3455,3726,4154,2341,5,125,05125,8043,11819,14771,9608,8165,12346,15352,11305,16208,24165,30123,20913,119415,58571,60844,105610,8518,1528,761,5688,64412,24883,52100.0,56903.0
1211,"Van Buren County, Arkansas",8214,409,461,331,371,459,472,300,5,141,05141,979,1203,2359,1975,868,1266,2399,2293,1847,2469,4758,4268,16642,8214,8428,15816,101,37,182,520,38499,3420,7339.0,7704.0
1212,"Izard County, Arkansas",7067,261,267,217,380,233,450,184,5,65,05065,1029,1147,2113,1607,661,925,1887,1783,1690,2072,4000,3390,13570,7067,6503,12751,248,0,50,314,42876,2682,5448.0,5792.0
1213,"Independence County, Arkansas",18350,1239,1286,787,1261,1187,1249,735,5,63,05063,2738,3409,4837,2805,2678,3349,4970,3648,5416,6758,9807,6453,37427,18350,19077,34101,720,264,1248,2363,44319,7329,13614.0,14486.0
1214,"Logan County, Arkansas",10677,628,562,520,639,720,610,384,5,83,05083,1522,1820,2931,2015,1397,1853,3119,2269,2919,3673,6050,4284,21668,10677,10991,19887,298,474,203,645,41466,4569,7921.0,8222.0
1215,"Grant County, Arkansas",8893,491,647,364,469,684,530,368,5,53,05053,1254,1665,2447,1507,1218,1630,2613,1721,2472,3295,5060,3228,18126,8893,9233,17180,482,7,47,498,55388,4113,7445.0,8197.0
1216,"Franklin County, Arkansas",8735,537,592,369,587,620,501,405,5,47,05047,1332,1493,2287,1512,1152,1462,2391,1885,2484,2955,4678,3397,17738,8735,9003,16682,174,146,72,536,38923,3204,6770.0,7113.0
1217,"Pike County, Arkansas",5312,283,294,185,291,391,309,226,5,109,05109,817,936,1439,998,704,867,1485,1171,1521,1803,2924,2169,10756,5312,5444,9774,439,61,279,700,40401,2150,3981.0,4246.0
1218,"Jefferson County, Arkansas",34282,2158,2155,1408,2013,2078,2024,1290,5,69,05069,6126,6486,8749,5034,5720,5946,9338,6591,11846,12432,18087,11625,69282,34282,35000,27475,39165,660,881,1455,40726,12000,25894.0,25030.0
1219,"Montgomery County, Arkansas",4478,242,269,167,171,213,257,155,5,97,05097,541,641,1293,1153,444,670,1312,1250,985,1311,2605,2403,8950,4478,4472,8247,30,36,274,388,35741,1743,3559.0,3839.0
1220,"Scott County, Arkansas",5313,429,321,323,312,349,341,151,5,127,05127,691,822,1303,1009,621,822,1326,1141,1312,1644,2629,2150,10376,5313,5063,9239,25,75,312,799,36092,1977,3510.0,2219.0
1221,"Sebastian County, Arkansas",62343,4214,4377,2677,4197,4170,4278,2583,5,131,05131,10271,11836,16021,8633,10242,11910,16607,11261,20513,23746,32628,19894,127591,62343,65248,93752,8642,5737,11990,18144,46228,20649,44637.0,46838.0
1222,"Crawford County, Arkansas",30903,2037,1784,1378,1911,1971,2344,1396,5,33,05033,4584,5727,8088,4654,4433,5785,8374,5622,9017,11512,16462,10276,62739,30903,31836,55246,993,1177,1902,4852,46828,11087,22450.0,24025.0
1223,"Chicot County, Arkansas",5239,316,342,177,290,379,332,206,5,17,05017,853,912,1449,868,607,796,1514,1252,1460,1708,2963,2120,10615,5239,5376,4614,5724,62,69,584,34147,1554,4176.0,4093.0
1224,"Johnson County, Arkansas",12966,809,977,544,836,817,983,547,5,71,05071,1997,2501,3314,1961,2112,2290,3497,2324,4109,4791,6811,4285,26372,12966,13406,24056,421,543,577,3671,38511,4775,9112.0,9402.0
1225,"Lee County, Arkansas",5220,237,227,168,232,200,243,138,5,77,05077,964,1335,1302,757,519,536,1134,972,1483,1871,2436,1729,9194,5220,3974,3949,5108,15,20,230,29681,1249,3026.0,2848.0
1226,"Marion County, Iowa",16498,928,1104,734,941,1010,1185,672,19,125,19125,2822,2833,4336,2571,2437,2881,4314,3234,5259,5714,8650,5805,33172,16498,16674,31772,349,371,139,639,61038,7302,17816.0,19217.0
1227,"Washington County, Iowa",10964,732,672,563,759,727,707,431,19,183,19183,1588,1846,2842,1846,1448,1868,2901,2295,3036,3714,5743,4141,22100,10964,11136,21043,172,132,392,1363,62556,4681,10929.0,11757.0
1228,"Wright County, Iowa",6434,412,369,288,363,447,429,223,19,197,19197,791,1036,1754,1258,682,1045,1568,1548,1473,2081,3322,2806,12739,6434,6305,11901,49,67,518,1541,53333,2578,6026.0,6240.0
1229,"Cass County, Iowa",6457,341,482,302,324,418,401,250,19,29,19029,768,1140,1763,1273,741,1000,1819,1681,1509,2140,3582,2954,13091,6457,6634,12695,26,43,79,354,50187,2765,7125.0,7266.0
1230,"Cherokee County, Iowa",5720,372,391,238,282,331,365,188,19,35,19035,707,897,1631,1214,611,823,1571,1452,1318,1720,3202,2666,11343,5720,5623,10762,228,90,6,182,56550,2514,6258.0,6503.0
1231,"Crawford County, Iowa",8491,453,493,375,660,702,481,364,19,47,19047,1415,1362,2377,1316,1210,1389,2153,1584,2625,2751,4530,2900,17034,8491,8543,14619,477,353,1087,4782,55755,2852,6935.0,7125.0
1232,"Des Moines County, Iowa",19149,1166,1268,709,1131,1080,1422,792,19,57,19057,2672,3222,5241,3510,2532,3454,5355,4471,5204,6676,10596,7981,39386,19149,20237,35502,2258,302,96,1266,51267,7328,19103.0,19897.0
1233,"Fayette County, Iowa",9956,553,688,367,520,559,567,350,19,65,19065,1579,1545,2822,1857,1439,1434,2676,2302,3018,2979,5498,4159,19803,9956,9847,18890,444,50,41,484,51128,4308,9975.0,10184.0
1234,"Harrison County, Iowa",7030,411,529,269,411,396,478,308,19,85,19085,924,1197,2022,1242,769,1164,2039,1494,1693,2361,4061,2736,14089,7030,7059,13739,27,69,16,245,63854,3085,7465.0,8137.0
1235,"Kossuth County, Iowa",7508,432,514,269,445,370,501,286,19,109,19109,972,1146,2128,1571,911,1104,1968,1885,1883,2250,4096,3456,14978,7508,7470,14481,114,84,76,402,56073,3057,8607.0,9030.0
1236,"Mills County, Iowa",7516,416,556,327,402,493,561,328,19,129,19129,902,1311,2199,1291,870,1263,2181,1420,1772,2574,4380,2711,15034,7516,7518,14492,103,70,103,480,72079,3008,7698.0,8247.0
1237,"Monona County, Iowa",4181,209,199,169,242,246,266,148,19,133,19133,600,618,1157,922,523,762,1159,1203,1123,1380,2316,2125,8730,4181,4549,8428,27,0,9,175,47605,1665,4572.0,4709.0
1238,"Muscatine County, Iowa",21323,1386,1717,870,1344,1438,1573,985,19,139,19139,3207,3996,5656,3104,3066,3855,5501,3804,6273,7851,11157,6908,42889,21323,21566,38753,1065,388,1360,7677,58453,8292,19434.0,20671.0
1239,"Osceola County, Iowa",3059,203,209,120,158,152,208,126,19,143,19143,378,502,839,568,299,463,886,701,677,965,1725,1269,6052,3059,2993,5717,76,8,127,490,59725,1205,3213.0,3325.0
1240,"Polk County, Iowa",236343,17588,16939,9578,16661,16538,16055,9390,19,153,19153,39490,51553,57582,26534,39827,50625,59485,34688,79317,102178,117067,61222,479612,236343,243269,402987,32518,21909,6456,40165,67637,99904,231555.0,258613.0
1241,"Webster County, Iowa",18874,1025,1308,712,1100,1016,1022,662,19,187,19187,3868,3335,4794,2909,2670,2747,4776,3678,6538,6082,9570,6587,36545,18874,17671,33123,1727,501,421,1838,47466,6791,17430.0,17802.0
1242,"Story County, Iowa",50622,2306,2420,1328,2144,2456,2023,1233,19,169,19169,20940,7803,8488,5143,16518,6881,8770,6294,37458,14684,17258,11437,96941,50622,46319,83428,2213,7795,861,3348,56756,19417,50667.0,50668.0
1243,"Woodbury County, Iowa",50762,3743,3719,2205,3643,3400,3988,2195,19,193,19193,8645,9634,12299,6565,8122,9485,12485,8506,16767,19119,24784,15071,102586,50762,51824,87959,3706,2908,2112,17049,59224,18278,43718.0,45114.0
1244,"Black Hawk County, Iowa",65087,4315,4210,2244,4081,3815,3893,2224,19,13,19013,14432,11614,14966,9403,14734,11299,15525,11735,29166,22913,30491,21138,132393,65087,67306,110821,12534,3145,1944,5827,53539,25965,64405.0,66549.0
1245,"Grundy County, Iowa",6087,328,472,256,335,390,417,240,19,75,19075,765,1103,1648,1118,709,1075,1645,1401,1474,2178,3293,2519,12299,6087,6212,12080,74,34,0,158,68038,2891,6872.0,7245.0
1246,"Jones County, Iowa",10633,537,631,372,497,607,681,394,19,105,19105,1486,1996,3025,1914,1110,1726,2681,2230,2596,3722,5706,4144,20559,10633,9926,19621,435,196,0,418,57549,4704,10133.0,10959.0
1247,"Mitchell County, Iowa",5233,310,400,226,297,334,329,239,19,131,19131,712,808,1437,991,686,771,1404,1315,1398,1579,2841,2306,10608,5233,5375,10333,32,49,39,157,58302,2312,5417.0,5797.0
1248,"Montgomery County, Iowa",4850,268,297,245,336,297,325,197,19,137,19137,596,782,1411,915,612,821,1430,1185,1208,1603,2841,2100,10053,4850,5203,9509,11,17,245,383,51696,1875,5044.0,5313.0
1249,"Sac County, Iowa",4840,300,305,186,280,270,345,183,19,161,19161,601,756,1370,1003,529,700,1388,1267,1130,1456,2758,2270,9802,4840,4962,9543,71,45,63,308,58232,2174,5212.0,5512.0
1250,"Plymouth County, Iowa",12296,764,860,541,785,808,846,631,19,149,19149,1588,2135,3352,2033,1547,2193,3464,2498,3135,4328,6816,4531,25068,12296,12772,23694,244,163,582,1311,67297,5216,13190.0,14157.0
1251,"Buchanan County, Iowa",10432,723,749,499,752,841,777,450,19,19,19019,1348,1883,2640,1732,1235,1873,2721,2037,2583,3756,5361,3769,21118,10432,10686,20564,36,54,2,333,64837,4822,10252.0,10759.0
1252,"Clinton County, Iowa",22958,1316,1241,928,1492,1146,1776,904,19,45,19045,2997,3971,6501,4118,3088,3994,6612,4939,6085,7965,13113,9057,46909,22958,23951,43921,1320,326,112,1472,51688,9824,23067.0,24620.0
1253,"Decatur County, Iowa",4009,257,259,148,240,265,219,135,19,53,19053,969,545,897,722,800,554,912,845,1769,1099,1809,1567,7979,4009,3970,7552,141,59,37,239,44462,1654,3734.0,3798.0
1254,"Jefferson County, Iowa",8889,423,298,269,376,422,425,255,19,101,19101,1469,1855,2383,1793,1486,1868,2305,2122,2955,3723,4688,3915,18148,8889,9259,15104,1305,790,252,552,47708,4446,8156.0,8952.0
1255,"Allamakee County, Iowa",6975,457,412,250,491,359,481,240,19,5,19005,861,1129,1905,1457,743,1036,1869,1619,1604,2165,3774,3076,13813,6975,6838,13324,176,79,50,914,52216,2917,6923.0,7459.0
1256,"Linn County, Iowa",110379,7187,7372,4747,6923,6994,7378,4392,19,113,19113,18193,21914,28090,15259,17992,21768,28523,19512,36185,43682,56613,34771,223861,110379,113482,197046,12389,5086,1706,7273,64903,45900,117098.0,126716.0
1257,"Dallas County, Iowa",42984,3460,3755,1939,3300,3500,3371,1780,19,49,19049,5834,10297,9950,4518,5964,10406,9955,5839,11798,20703,19905,10357,87099,42984,44115,78883,1654,3928,680,5334,88479,20654,38252.0,55803.0
1258,"O'Brien County, Iowa",6845,379,398,283,486,549,367,261,19,141,19141,905,1239,1856,1229,830,1102,1788,1607,1735,2341,3644,2836,13835,6845,6990,13250,175,132,103,681,53703,3063,7406.0,7535.0
1259,"Stanton County, Kansas",1010,66,108,62,85,58,119,31,20,187,20187,160,153,233,143,184,144,213,208,344,297,446,351,2052,1010,1042,1993,0,0,5,833,52054,281,637.0,767.0
1260,"Meade County, Kansas",2090,133,148,96,130,140,135,104,20,119,20119,340,343,538,327,303,320,561,397,643,663,1099,724,4180,2090,2090,3541,26,30,454,856,59316,639,1720.0,1807.0
1261,"Montgomery County, Kansas",16205,1132,1185,694,914,1066,1111,536,20,125,20125,2538,2741,4119,2714,2179,2615,4351,3544,4717,5356,8470,6258,32521,16205,16316,27395,1638,317,533,2197,45157,5350,12004.0,13177.0
1262,"Pratt County, Kansas",4724,415,317,195,329,320,317,167,20,151,20151,840,696,1123,787,656,703,1238,998,1496,1399,2361,1785,9452,4724,4728,8917,239,10,14,676,52327,1762,3842.0,4107.0
1263,"Rawlins County, Kansas",1277,65,86,32,75,62,57,49,20,153,20153,147,208,346,306,117,180,319,366,264,388,665,672,2502,1277,1225,2312,16,3,110,180,53207,554,1472.0,1498.0
1264,"Anderson County, Kansas",3891,247,325,198,231,220,338,187,20,3,20003,505,572,989,764,442,652,981,893,947,1224,1970,1657,7835,3891,3944,7577,39,1,0,148,50213,1684,3350.0,3720.0
1265,"Ellsworth County, Kansas",3536,176,154,119,149,152,137,90,20,53,20053,664,730,913,610,303,423,767,674,967,1153,1680,1284,6231,3536,2695,5647,199,80,56,384,54902,1286,2679.0,2813.0
1266,"Geary County, Kansas",18172,2154,1824,614,1950,1348,1177,504,20,61,20061,5517,3765,2180,1181,3758,3329,2201,1586,9275,7094,4381,2767,34025,18172,15853,23076,6376,1006,921,5506,53133,4495,7504.0,9311.0
1267,"Ford County, Kansas",17756,1504,1561,865,1581,1359,1344,738,20,57,20057,3334,3383,4056,1660,2707,2992,3744,1958,6041,6375,7800,3618,34179,17756,16423,30528,685,469,1423,18817,51711,4640,7718.0,8850.0
1268,"Russell County, Kansas",3451,212,276,118,187,167,236,106,20,167,20167,432,560,961,747,373,500,1038,890,805,1060,1999,1637,6948,3451,3497,6567,160,0,20,237,44792,1373,3193.0,3436.0
1269,"Marshall County, Kansas",4887,316,336,203,301,314,338,195,20,117,20117,569,830,1321,975,543,748,1317,1106,1112,1578,2638,2081,9749,4887,4862,9430,30,38,26,246,51895,2438,4673.0,5029.0
1270,"Allen County, Kansas",6217,378,442,279,344,374,378,220,20,1,20001,935,1056,1609,1098,837,1004,1739,1443,1772,2060,3348,2541,12556,6217,6339,11683,125,94,16,446,45333,2474,5454.0,7484.0
1271,"Cheyenne County, Kansas",1326,91,91,43,56,76,64,66,20,23,20023,166,212,329,313,148,212,325,392,314,424,654,705,2665,1326,1339,2554,0,0,100,181,47639,590,1407.0,1400.0
1272,"Cowley County, Kansas",17848,1212,1168,765,978,1224,1136,646,20,35,20035,2988,3223,4340,2875,2677,2836,4482,3524,5665,6059,8822,6399,35351,17848,17503,31109,1159,569,402,3839,50102,6436,12621.0,13958.0
1273,"Elk County, Kansas",1233,70,43,42,56,39,126,58,20,49,20049,108,148,373,338,99,163,357,392,207,311,730,730,2523,1233,1290,2367,10,12,1,115,38750,630,1259.0,1347.0
1274,"Franklin County, Kansas",12546,757,895,542,777,1063,697,548,20,59,20059,1870,2184,3494,1913,1865,2228,3542,2292,3735,4412,7036,4205,25558,12546,13012,23867,237,98,334,1065,56582,5139,10965.0,12247.0
1275,"Hodgeman County, Kansas",956,75,32,33,45,51,50,54,20,83,20083,139,119,300,191,106,123,269,222,245,242,569,413,1876,956,920,1794,1,36,4,149,61211,358,1017.0,1033.0
1276,"Jewell County, Kansas",1473,76,81,40,73,83,58,54,20,89,20089,155,223,396,412,141,156,404,443,296,379,800,855,2885,1473,1412,2781,10,5,35,69,40676,609,1494.0,1608.0
1277,"Rice County, Kansas",4853,281,359,222,302,414,249,152,20,159,20159,968,774,1228,789,787,685,1205,1011,1755,1459,2433,1800,9658,4853,4805,8786,189,79,204,1100,53012,1606,3804.0,4230.0
1278,"Stafford County, Kansas",2126,135,121,110,126,97,151,69,20,185,20185,277,301,618,402,240,329,564,479,517,630,1182,881,4181,2126,2055,3962,12,4,71,558,49375,850,1896.0,2017.0
1279,"Osage County, Kansas",7953,460,530,383,423,575,446,314,20,139,20139,976,1221,2309,1500,976,1273,2316,1605,1952,2494,4625,3105,15881,7953,7928,15238,94,30,24,516,54090,3406,7046.0,7883.0
1280,"Coffey County, Kansas",4204,223,218,202,212,212,261,152,20,31,20031,574,708,1154,827,502,645,1176,890,1076,1353,2330,1717,8254,4204,4050,7893,66,8,12,222,59583,1666,4068.0,4442.0
1281,"Crawford County, Kansas",19495,1215,1475,761,1116,1031,1313,614,20,37,20037,5069,3215,4208,2551,4510,3189,4331,3369,9579,6404,8539,5920,38968,19495,19473,35547,884,724,269,2225,41004,7247,14891.0,16193.0
1282,"Greenwood County, Kansas",3065,141,219,121,156,183,180,107,20,73,20073,333,462,884,712,286,459,854,791,619,921,1738,1503,6081,3065,3016,5782,13,11,11,236,41982,1243,2840.0,3036.0
1283,"Carroll County, Maryland",82963,4652,5179,3701,4275,4832,5221,3524,24,13,24013,12273,14364,25298,12201,11397,14277,25977,15233,23670,28641,51275,27434,167699,82963,84736,153534,5924,3176,1163,5921,96769,40057,91848.0,86188.0
1284,"Queen Anne's County, Maryland",24634,1312,1483,1003,1201,1431,1635,981,24,35,24035,3279,3925,7634,4277,2920,4272,7716,4842,6199,8197,15350,9119,49632,24634,24998,44328,3302,504,621,1955,97034,11514,26523.0,28990.0
1285,"St. Mary's County, Maryland",56147,3621,3404,2405,3525,3407,4285,2295,24,37,24037,9453,11010,15270,6581,9031,10878,15212,7510,18484,21888,30482,14091,112290,56147,56143,87625,16431,2865,1066,5819,89845,21742,49842.0,54097.0
1286,"Charles County, Maryland",76779,4876,5425,3629,4691,5063,5629,3552,24,17,24017,12431,14386,21988,8436,11954,16388,24396,10976,24385,30774,46384,19412,159428,76779,82649,70090,73300,5115,1158,9212,100003,32050,78303.0,64714.0
1287,"Dorchester County, Maryland",15177,907,874,635,910,804,1110,536,24,19,24019,2077,2370,4287,2994,2207,2738,4913,3743,4284,5108,9200,6737,32138,15177,16961,21065,8549,354,409,1815,52917,6333,15225.0,13371.0
1288,"Washington County, Maryland",76330,4434,4624,3027,4225,4446,4568,2899,24,43,24043,12356,14952,21094,11121,9889,12999,20635,14118,22245,27951,41729,25239,150109,76330,73779,123236,15984,2755,1634,7616,60860,31379,65991.0,62972.0
1289,"Wicomico County, Maryland",48681,3107,2832,1938,3078,3226,2846,1951,24,45,24045,10272,8110,12010,6885,11636,8831,13328,8962,21908,16941,25338,15847,102539,48681,53858,68178,26594,3215,1467,5376,56956,17825,42547.0,42944.0
1290,"Cecil County, Maryland",51022,3050,3521,2247,2688,3133,3306,2059,24,15,24015,7563,9194,14764,7355,7316,9242,15502,8284,14879,18436,30266,15639,102552,51022,51530,90069,6974,1446,1011,4525,76887,22234,45269.0,44672.0
1291,"Caroline County, Maryland",16170,1013,1138,642,996,1102,1098,704,24,11,24011,2359,3044,4460,2366,2272,3163,4611,2933,4631,6207,9071,5299,33049,16170,16879,26405,4666,229,733,2417,58638,6841,14113.0,13110.0
1292,"Suffolk County, Massachusetts",384878,21511,17131,10843,20780,17368,17164,10637,25,25,25025,102852,92285,82732,39323,110122,92452,88815,54389,212974,184737,171547,93712,796605,384878,411727,439961,178557,70597,52405,182360,69669,194153,308741.0,314110.0
1293,"Dukes County, Massachusetts",8535,300,445,299,336,347,623,296,25,7,25007,1157,1419,2467,1887,970,1453,2606,2146,2127,2872,5073,4033,17312,8535,8777,15247,813,59,346,630,71811,4711,11502.0,12587.0
1294,"Middlesex County, Massachusetts",783073,44030,44058,28799,42399,43053,43638,27492,25,17,25017,143278,165695,207513,103690,139111,166739,219112,136225,282389,332434,426625,239915,1600842,783073,817769,1227271,85583,190905,45312,127980,102603,475904,784034.0,842171.0
1295,"Bristol County, Massachusetts",271591,15037,15812,10839,14580,15688,16568,10368,25,5,25005,44358,50569,77348,39919,43686,53112,82065,53379,88044,103681,159413,93298,561037,271591,289446,471827,23969,12741,34815,44846,69095,119139,248959.0,274045.0
1296,"Hampden County, Massachusetts",225964,13408,13597,9584,12646,14091,13678,9145,25,13,25013,41044,39996,59766,32976,39639,43569,65102,44037,80683,83565,124868,77013,467871,225964,241907,381040,41471,11197,19095,117760,55429,94197,203117.0,210828.0
1297,"Essex County, Massachusetts",377772,22595,22068,15634,21563,21614,23848,14921,25,9,25009,61152,68648,105822,56001,59765,72878,116429,74886,120917,141526,222251,130887,783676,377772,405904,626140,33424,26899,71852,164027,79263,180969,379868.0,410009.0
1298,"Franklin County, Massachusetts",34374,1611,1544,1193,1451,1575,1891,1100,25,11,25011,4692,6178,10413,6745,4455,6284,11272,8175,9147,12462,21685,14920,70577,34374,36203,65480,1066,908,967,2835,60950,19938,38177.0,23784.0
1299,"Worcester County, Massachusetts",406642,22879,23973,16693,21618,22762,25306,15868,25,27,25027,68302,75915,116716,55623,65355,76906,119910,70405,133657,152821,236626,126028,824772,406642,418130,690146,41366,40508,26623,94778,74679,194491,383705.0,419486.0
1300,"Hampshire County, Massachusetts",75294,2913,3044,2488,2622,2986,3644,2364,25,15,25015,20426,11934,18771,11868,25577,12217,21443,14885,46003,24151,40214,26753,161032,75294,85738,141084,4186,8483,1608,9047,70876,41405,82956.0,84745.0
1301,"Chippewa County, Michigan",20498,917,970,607,915,828,1012,612,26,33,26033,4086,4088,5608,3202,3022,2819,4474,3449,7108,6907,10082,6651,37629,20498,17131,26615,2265,372,32,709,46486,6737,15456.0,17675.0
1302,"Monroe County, Michigan",73880,4078,4259,3161,3762,4080,4995,3063,26,115,26115,10770,12946,21889,11821,10136,12950,22478,14383,20906,25896,44367,26204,149727,73880,75847,141090,3568,864,656,5359,62203,30053,74218.0,87223.0
1303,"Oakland County, Michigan",612894,34913,36075,25425,33143,33806,38802,24311,26,125,26125,96203,117655,173420,89655,90009,118941,185882,115397,186212,236596,359302,205052,1253185,612894,640291,940365,170488,93551,9724,51653,79698,316357,664614.0,778418.0
1304,"Hillsdale County, Michigan",22841,1390,1282,944,1347,1237,1430,893,26,59,26059,3528,3632,6500,4043,3373,3643,6317,4676,6901,7275,12817,8719,45757,22841,22916,44217,332,180,144,1061,49622,8844,19940.0,23288.0
1305,"Muskegon County, Michigan",86161,5420,5805,3576,5195,5248,5852,3503,26,121,26121,13607,16194,23136,12706,12544,15480,23479,15835,26151,31674,46615,28541,173297,86161,87136,140103,23499,955,947,9809,50854,30843,78088.0,91701.0
1306,"Leelanau County, Michigan",10727,460,531,377,420,427,529,307,26,89,26089,1199,1443,3086,3146,1113,1423,3350,3356,2312,2866,6436,6502,21652,10727,10925,20123,105,137,189,945,65249,5642,14757.0,16930.0
1307,"Lapeer County, Michigan",44834,2190,2624,1974,2121,2377,2602,1804,26,87,26087,6461,7442,14083,7339,5440,7026,13684,8150,11901,14468,27767,15489,88038,44834,43204,84158,1108,500,553,4114,62641,17854,45183.0,52639.0
1308,"Sanilac County, Michigan",20509,1094,1189,825,1051,1341,1140,905,26,151,26151,2665,3243,6064,4032,2483,3196,6024,4646,5148,6439,12088,8678,41295,20509,20786,39896,222,113,322,1522,47672,8759,19249.0,22446.0
1309,"Keweenaw County, Michigan",1089,34,40,27,41,66,20,38,26,83,26083,100,149,293,400,80,122,314,341,180,271,607,741,2111,1089,1022,2048,19,4,0,17,50292,589,1434.0,1557.0
1310,"Ontonagon County, Michigan",3012,77,78,84,68,105,88,91,26,131,26131,235,322,1003,1078,207,300,1001,1005,442,622,2004,2083,5877,3012,2865,5640,29,25,8,89,41546,1399,3426.0,3810.0
1311,"Ottawa County, Michigan",141600,9175,9992,6341,8688,9128,10045,5789,26,139,26139,27718,25378,33921,18953,28506,25193,34669,22940,56224,50571,68590,41893,286558,141600,144958,256755,4425,7747,8670,28112,69314,54614,142734.0,168074.0
1312,"Alcona County, Michigan",5235,154,178,151,162,198,176,114,26,1,26001,450,555,1682,1855,398,566,1648,1856,848,1121,3330,3711,10353,5235,5118,10028,41,20,35,155,40484,2407,6198.0,7063.0
1313,"Ionia County, Michigan",34266,1929,1998,1406,1740,1845,2421,1223,26,67,26067,5890,7036,9415,4321,4048,5579,8176,5002,9938,12615,17591,9323,64300,34266,30034,58958,2976,269,460,3067,57043,12609,26854.0,32201.0
1314,"Kalkaska County, Michigan",8943,441,492,352,450,485,564,290,26,79,26079,1138,1573,2617,1719,1055,1465,2576,1757,2193,3038,5193,3476,17585,8943,8642,16871,170,95,7,354,46898,3503,8833.0,10627.0
1315,"Berrien County, Michigan",75425,4542,5090,3045,4415,4736,4514,2898,26,21,26021,11217,12993,20752,13197,10702,13252,21644,16547,21919,26245,42396,29744,154133,75425,78708,121313,22561,2931,1847,8449,50795,29780,72031.0,82404.0
1316,"Ogemaw County, Michigan",10528,508,538,378,457,517,510,346,26,129,26129,1223,1500,3192,2577,1147,1484,3211,2698,2370,2984,6403,5275,20898,10528,10370,20169,68,136,34,449,40373,4091,10387.0,11907.0
1317,"Wexford County, Michigan",16599,1027,1160,616,984,1082,1154,630,26,165,26165,2248,2833,4643,2966,2074,2820,4682,3231,4322,5653,9325,6197,33256,16599,16657,31836,245,180,47,653,47193,6399,15298.0,18292.0
1318,"Crawford County, Michigan",7065,310,369,248,339,364,274,238,26,39,26039,833,939,2283,1714,759,930,2176,1747,1592,1869,4459,3461,13892,7065,6827,13337,103,129,61,279,47977,2821,6844.0,7665.0
1319,"Dickinson County, Michigan",12759,632,781,463,629,647,683,510,26,43,26043,1680,2094,3817,2588,1398,2023,3787,3003,3078,4117,7604,5591,25439,12759,12680,24356,158,166,102,399,51645,5434,13165.0,13268.0
1320,"Huron County, Michigan",15550,780,811,544,755,861,831,562,26,63,26063,1932,2298,4701,3564,1746,2160,4699,4185,3678,4458,9400,7749,31349,15550,15799,30404,150,199,102,754,48289,7119,15917.0,17523.0
1321,"Ingham County, Michigan",141572,8266,7806,5079,7999,7718,7819,4836,26,65,26065,39335,25164,30935,16617,39782,25417,33950,21494,79117,50581,64885,38111,290587,141572,149015,216025,33930,19624,4396,22675,52872,58384,131138.0,144797.0
1322,"Mason County, Michigan",14333,724,782,515,774,822,758,579,26,105,26105,1915,2221,4068,3132,1669,2283,4187,3549,3584,4504,8255,6681,28954,14333,14621,27438,261,167,196,1322,51725,5955,14685.0,17249.0
1323,"Menominee County, Michigan",11700,563,607,466,447,552,593,436,26,109,26109,1386,1859,3626,2599,1319,1687,3483,2857,2705,3546,7109,5456,23074,11700,11374,21756,73,94,23,419,46828,5146,10768.0,12622.0
1324,"Missaukee County, Michigan",7648,502,491,319,487,459,460,272,26,113,26113,1005,1192,2153,1496,881,1194,2066,1561,1886,2386,4219,3057,15028,7648,7380,14463,95,29,65,437,47194,3221,7317.0,8755.0
1325,"St. Joseph County, Michigan",30353,2110,1986,1356,1923,1975,2157,1233,26,149,26149,4481,5360,8025,4769,4116,5277,8004,5798,8597,10637,16029,10567,60836,30353,30483,55964,1353,305,1050,4822,52086,11008,23757.0,27982.0
1326,"Van Buren County, Michigan",37494,2378,2283,1685,2198,2414,2530,1465,26,159,26159,5153,6492,10508,6218,4800,6558,10859,7040,9953,13050,21367,13258,75358,37494,37864,64935,2520,534,3401,8685,54485,14063,33274.0,39060.0
1327,"Arenac County, Michigan",7635,351,373,272,331,370,370,254,26,11,26011,908,1144,2398,1789,793,1107,2337,1873,1701,2251,4735,3662,15070,7635,7435,14500,62,55,20,304,42290,3188,7696.0,8830.0
1328,"Barry County, Michigan",30464,1735,1866,1337,1622,1800,1953,1170,26,15,26015,4130,5200,9073,5135,3868,5199,8682,5782,7998,10399,17755,10917,60540,30464,30076,58329,415,364,362,1786,64490,13148,30329.0,35914.0
1329,"Iron County, Michigan",5543,192,318,171,229,250,261,158,26,71,26071,565,733,1757,1598,507,729,1729,1746,1072,1462,3486,3344,11152,5543,5609,10681,61,65,23,234,41599,2557,5910.0,6795.0
1330,"Benzie County, Michigan",8750,479,373,318,357,426,466,294,26,19,26019,976,1310,2577,2180,904,1305,2748,2365,1880,2615,5325,4545,17615,8750,8865,16863,32,76,10,441,57974,4337,10228.0,12259.0
1331,"Schoolcraft County, Michigan",3930,127,214,148,208,187,209,112,26,153,26153,423,526,1276,1032,418,526,1358,1100,841,1052,2634,2132,8048,3930,4118,6958,36,30,9,89,45500,1792,4154.0,4745.0
1332,"Wayne County, Michigan",846179,59019,58089,36643,56364,55864,56784,35681,26,163,26163,144959,152274,224167,111749,146266,165739,241684,152738,291225,318013,465851,264487,1757299,846179,911120,933616,680932,58915,34182,104419,47301,281703,777838.0,863382.0
1333,"Grand Traverse County, Michigan",45476,2516,2685,1668,2284,2683,2464,1654,26,55,26055,6522,8422,12941,7913,6226,8206,13411,9777,12748,16628,26352,17690,92181,45476,46705,87402,835,537,342,2639,63575,19824,51589.0,60226.0
1334,"Mackinac County, Michigan",5494,188,233,184,201,214,234,177,26,97,26097,728,756,1701,1445,525,715,1717,1503,1253,1471,3418,2948,10780,5494,5286,8023,363,74,21,191,47938,2233,6097.0,6922.0
1335,"Genesee County, Michigan",196695,12299,13201,8495,11885,12061,13197,8204,26,49,26049,30918,34007,54071,30258,31079,36786,58889,39079,61997,70793,112960,69337,407875,196695,211180,304896,81062,4211,2088,14027,48588,69469,196296.0,222969.0
1336,"Labette County, Kansas",9902,667,595,457,657,649,666,373,20,99,20099,1517,1623,2698,1623,1218,1666,2894,2094,2735,3289,5592,3717,20119,9902,10217,17858,957,31,107,911,47643,3608,8107.0,8414.0
1337,"Sedgwick County, Kansas",253563,18508,18942,11090,17713,18375,18513,10724,20,173,20173,43797,48664,61279,32221,41718,49629,63307,39833,85515,98293,124586,72054,513375,253563,259812,399953,45401,22290,18036,74791,56524,94231,188783.0,214488.0
1338,"Republic County, Kansas",2244,130,118,86,112,144,143,82,20,157,20157,236,321,636,562,218,328,672,715,454,649,1308,1277,4658,2244,2414,4539,53,11,0,95,47976,1181,2529.0,2643.0
1339,"Graham County, Kansas",1261,58,94,35,61,63,62,48,20,65,20065,125,188,350,318,130,188,356,350,255,376,706,668,2519,1261,1258,2274,105,44,0,50,46375,549,1284.0,1302.0
1340,"Douglas County, Kansas",59669,2916,2992,1978,3177,3578,2591,1680,20,45,20045,19469,11156,11454,6393,18753,10781,12249,7812,38222,21937,23703,14205,120290,59669,60621,99132,5254,6347,1272,7555,59435,26563,50087.0,57946.0
1341,"Sheridan County, Kansas",1286,97,100,53,42,83,95,56,20,179,20179,132,210,348,278,125,196,312,311,257,406,660,589,2506,1286,1220,2417,25,0,41,128,62885,583,1374.0,1397.0
1342,"Gray County, Kansas",3031,238,206,126,215,245,231,177,20,69,20069,399,553,747,427,394,602,676,468,793,1155,1423,895,6039,3031,3008,5847,53,7,2,964,64930,858,2066.0,2240.0
1343,"Todd County, South Dakota",4957,670,557,318,625,642,569,286,46,121,46121,893,778,833,314,872,907,894,443,1765,1685,1727,757,10195,4957,5238,849,6,189,19,118,24331,823,2125.0,2539.0
1344,"Oglala Lakota County, South Dakota",7024,771,697,393,698,801,721,415,46,102,46102,1439,1253,1315,327,1426,1266,1336,648,2865,2519,2651,975,14335,7024,7311,737,11,0,20,585,31997,878,,3200.0
1345,"Klickitat County, Washington",10928,539,592,371,552,462,687,390,53,39,53039,1239,1888,3093,2571,1183,1786,3178,2555,2422,3674,6271,5126,21721,10928,10793,20173,160,155,210,2605,55773,4507,10769.0,11621.0
1346,"Grays Harbor County, Washington",37317,1884,2109,1367,2011,2041,2017,1232,53,27,53027,5112,6910,10316,7344,4249,5914,10043,7955,9361,12824,20359,15299,72779,37317,35462,63802,859,1096,583,7246,51240,13433,28367.0,36652.0
1347,"Wahkiakum County, Washington",2017,81,111,23,87,104,120,89,53,69,53069,187,274,549,706,199,274,674,704,386,548,1223,1410,4268,2017,2251,3877,54,79,154,294,53227,884,2358.0,2931.0
1348,"Grant County, Washington",48538,3806,4042,2319,3886,4061,3829,2182,53,25,53025,8440,8784,10818,6191,7532,8491,10292,6691,15972,17275,21110,12882,95502,48538,46964,65761,810,946,22769,39700,55556,12044,28346.0,25575.0
1349,"Snohomish County, Washington",400594,26114,25040,15342,24606,24152,24966,14722,53,61,53061,62298,88508,109852,46709,57989,84638,109205,57936,120287,173146,219057,104645,798808,400594,398214,601915,24369,86121,24764,81495,86691,169858,342173.0,428889.0
1350,"Summers County, West Virginia",5916,240,251,227,243,298,318,198,54,89,54089,663,979,1724,1450,755,1360,2095,1665,1418,2339,3819,3115,12848,5916,6932,11967,586,0,11,190,38187,2888,4862.0,5583.0
1351,"Greenbrier County, West Virginia",17088,925,817,625,893,848,1115,626,54,25,54025,2237,2978,4836,3607,2133,3063,5045,4344,4370,6041,9881,7951,35155,17088,18067,33010,996,217,219,697,40200,7382,14066.0,15827.0
1352,"Mineral County, West Virginia",13617,687,658,630,679,693,713,448,54,57,54057,2151,2165,3695,2669,1797,2160,3949,3111,3948,4325,7644,5780,27167,13617,13550,25742,925,116,65,250,49936,6464,11564.0,12652.0
1353,"Lewis County, West Virginia",8120,520,445,279,471,368,567,261,54,41,54041,1091,1472,2289,1507,976,1366,2275,1762,2067,2838,4564,3269,16166,8120,8046,15744,29,81,27,200,39908,3856,6928.0,7423.0
1354,"Pocahontas County, West Virginia",4336,204,122,135,201,212,203,112,54,75,54075,522,745,1314,1021,471,618,1219,1078,993,1363,2533,2099,8450,4336,4114,8334,37,9,26,49,41882,2070,3646.0,3979.0
1355,"Randolph County, West Virginia",14844,747,833,517,748,951,600,443,54,83,54083,2332,2655,4202,2857,1982,2251,3855,3256,4314,4906,8057,6113,28930,14844,14086,27883,620,160,97,279,43320,6825,10876.0,12172.0
1356,"Wirt County, West Virginia",2936,109,185,138,183,130,204,76,54,105,54105,335,486,881,591,325,506,892,546,660,992,1773,1137,5798,2936,2862,5762,26,0,10,27,46048,1222,2422.0,2617.0
1357,"Clay County, West Virginia",4338,256,289,132,237,231,291,216,54,15,54015,551,697,1252,851,506,738,1255,897,1057,1435,2507,1748,8709,4338,4371,8658,1,0,0,15,35024,2013,2972.0,3346.0
1358,"Monongalia County, West Virginia",54477,2820,2070,1420,2469,2396,2175,1240,54,61,54061,17375,11133,11158,5805,15080,9652,10963,7022,32455,20785,22121,12827,105474,54477,50997,94397,3781,3644,741,2246,52455,23765,36048.0,41873.0
1359,"Wetzel County, West Virginia",7469,391,361,304,385,381,605,281,54,103,54103,1012,1180,2148,1595,969,1212,2214,1920,1981,2392,4362,3515,15436,7469,7967,15093,164,0,41,132,43107,3584,6265.0,6596.0
1360,"Kanawha County, West Virginia",88317,4939,5741,3231,4968,4960,5231,3167,54,39,54039,12731,16543,24590,15907,12669,16558,26707,20702,25400,33101,51297,36609,183279,88317,94962,162196,13154,2208,319,2037,46639,40940,75690.0,82001.0
1361,"Preston County, West Virginia",17286,887,1126,533,855,983,766,556,54,77,54077,2514,3489,4873,3060,2131,3023,4584,3499,4645,6512,9457,6559,33683,17286,16397,31044,1717,85,190,849,51888,7962,12659.0,14508.0
1362,"Ritchie County, West Virginia",4884,220,165,180,244,331,220,162,54,85,54085,586,735,1514,1052,614,770,1418,1201,1200,1505,2932,2253,9844,4884,4960,9592,27,0,62,70,43577,2392,4075.0,4269.0
1363,"Lincoln County, West Virginia",10366,585,828,400,612,589,698,368,54,43,54043,1324,1822,2949,1846,1285,1880,3008,2044,2609,3702,5957,3890,20850,10366,10484,20495,39,24,0,145,42345,4338,7066.0,7775.0
1364,"Braxton County, West Virginia",7162,368,414,244,366,398,368,238,54,7,54007,966,1179,2049,1541,843,1153,2019,1643,1809,2332,4068,3184,14190,7162,7028,13757,106,0,10,31,41466,3351,5090.0,5650.0
1365,"Boone County, West Virginia",11124,564,685,473,541,711,660,448,54,5,54005,1478,1942,3277,1972,1294,2037,3250,2303,2772,3979,6527,4275,22368,11124,11244,21915,218,26,5,89,40739,5090,8683.0,8983.0
1366,"Wyoming County, West Virginia",10477,559,415,473,517,642,552,416,54,109,54109,1323,1830,3007,2016,1266,1920,3084,2407,2589,3750,6091,4423,21281,10477,10804,20716,262,54,25,67,42332,4802,7831.0,8485.0
1367,"Dunn County, Wisconsin",22476,1228,1320,785,1110,1205,1201,740,55,33,55033,5662,3783,5318,3107,5433,3575,5301,3718,11095,7358,10619,6825,44759,22476,22283,42081,292,1223,140,848,58783,8952,22091.0,23543.0
1368,"Grant County, Wisconsin",26853,1397,1635,949,1374,1370,1608,840,55,43,55043,7013,4200,6292,3867,5074,3629,6121,4864,12087,7829,12413,8731,51733,26853,24880,49897,776,504,92,868,54800,10456,24321.0,25379.0
1369,"Sheboygan County, Wisconsin",57965,3263,3465,2432,3145,3594,3572,2274,55,117,55117,8536,10703,16483,9125,7538,9905,16192,10993,16074,20608,32675,20118,115178,57965,57213,102224,2280,6610,1301,7334,60696,24429,59655.0,66020.0
1370,"Menominee County, Wisconsin",2297,191,194,208,183,166,205,92,55,78,55078,367,281,556,249,362,373,538,342,729,654,1094,591,4558,2297,2261,496,13,7,3,276,40921,480,1279.0,1586.0
1371,"Buffalo County, Wisconsin",6683,340,325,243,342,327,434,249,55,11,55011,813,1078,2043,1420,731,1026,1914,1420,1544,2104,3957,2840,13126,6683,6443,12720,95,12,114,283,57829,3102,6988.0,7811.0
1372,"La Crosse County, Wisconsin",57478,3035,3316,2029,3030,3127,3319,1981,55,63,55063,12809,10429,13872,8374,14093,9897,14665,10304,26902,20326,28537,18678,117894,57478,60416,107194,1831,5186,844,2265,57882,24238,62968.0,67848.0
1373,"Marathon County, Wisconsin",68016,4176,4637,2770,3834,4137,4476,2681,55,73,55073,9678,12645,19023,10685,8928,12122,18718,12484,18606,24767,37741,23169,135396,68016,67380,122592,810,7873,850,3777,62633,29025,69515.0,76741.0
1374,"Trempealeau County, Wisconsin",14983,1072,939,629,1002,924,1064,576,55,121,55121,1837,2656,4214,2493,1793,2508,3907,2742,3630,5164,8121,5235,29499,14983,14516,27339,166,128,1491,2479,58548,6294,13675.0,15356.0
1375,"Dodge County, Wisconsin",45623,2016,2464,1664,2041,2421,2879,1799,55,27,55027,6627,9255,13913,6846,5127,7146,12420,8259,11754,16401,26333,15105,87715,45623,42092,82065,2472,571,638,4202,60652,19079,43065.0,48497.0
1376,"Vilas County, Wisconsin",11037,400,463,312,414,477,448,340,55,125,55125,1077,1392,3423,3240,917,1298,3416,3404,1994,2690,6839,6644,21751,11037,10714,18895,110,131,52,566,47072,5024,13612.0,15338.0
1377,"Manitowoc County, Wisconsin",39500,2123,2374,1561,1996,2271,2206,1502,55,71,55071,5101,6888,11953,7110,4871,6397,11831,8611,9972,13285,23784,15721,79185,39500,39685,74419,869,2161,219,3178,56612,17280,40346.0,44808.0
1378,"Burnett County, Wisconsin",7857,363,422,269,292,339,360,235,55,13,55013,731,1012,2474,2151,713,1013,2345,2135,1444,2025,4819,4286,15289,7857,7432,13986,85,52,21,285,52672,3392,8743.0,10141.0
1379,"Door County, Wisconsin",13489,498,592,412,534,468,757,428,55,29,55029,1411,2053,4081,3693,1263,2072,4193,4268,2674,4125,8274,7961,27472,13489,13983,26447,222,137,166,859,61560,7042,17608.0,20117.0
1380,"Fond du Lac County, Wisconsin",50579,2830,3390,1843,2785,2877,3172,2085,55,39,55039,7530,9173,14621,8225,7275,9150,14534,10140,14805,18323,29155,18365,102597,50579,52018,95232,1448,1275,1789,5284,62391,22513,51327.0,57322.0
1381,"Pepin County, Wisconsin",3690,211,213,126,183,219,203,119,55,91,55091,458,567,1090,780,402,545,1091,813,860,1112,2181,1593,7265,3690,3575,7124,21,22,6,135,54583,1657,3739.0,4140.0
1382,"Richland County, Wisconsin",8766,454,500,342,418,589,503,326,55,103,55103,1165,1376,2452,1825,1022,1317,2499,2019,2187,2693,4951,3844,17459,8766,8693,16672,164,126,277,405,51947,4084,8055.0,9016.0
1383,"Waushara County, Wisconsin",12742,622,631,400,549,517,742,422,55,137,55137,1489,2166,4005,2833,1130,1617,3552,2922,2619,3783,7557,5755,24193,12742,11451,22449,342,85,673,1541,52810,5487,11999.0,13564.0
1384,"Lafayette County, Wisconsin",8468,570,627,373,486,565,565,374,55,65,55065,1108,1411,2395,1467,1008,1374,2303,1572,2116,2785,4698,3039,16715,8468,8247,16270,101,89,103,652,60691,3759,7662.0,8557.0
1385,"Pierce County, Wisconsin",20790,1106,1152,750,932,1229,1340,724,55,93,55093,4171,3561,5601,2927,4859,3548,5498,3057,9030,7109,11099,5984,41977,20790,21187,40164,233,535,173,902,72323,8836,21189.0,23336.0
1386,"Calumet County, Wisconsin",25024,1355,1838,1154,1362,1611,1807,1200,55,15,55015,3332,4745,7468,3346,2937,4749,7426,3812,6269,9494,14894,7158,49928,25024,24904,47224,426,1203,297,2144,75814,10874,26650.0,30858.0
1387,"Kenosha County, Wisconsin",83347,5033,5362,3733,4675,4774,6116,3628,55,59,55059,14029,15720,23368,10280,13360,16013,23908,12703,27389,31733,47276,22983,168524,83347,85177,144055,12757,2672,3503,22028,63733,32614,77076.0,88691.0
1388,"Johnson County, Wyoming",4435,210,274,143,215,257,283,116,56,19,56019,517,728,1213,975,377,673,1163,968,894,1401,2376,1943,8487,4435,4052,7938,49,0,34,232,58132,1993,4417.0,4914.0
1389,"Wallace County, Kansas",768,51,66,34,52,66,66,30,20,199,20199,109,111,201,152,88,125,182,197,197,236,383,349,1574,768,806,1480,3,6,32,74,63269,311,798.0,817.0
1390,"Chase County, Kansas",1354,72,82,62,49,71,113,31,20,17,20017,166,228,325,296,160,174,344,341,326,402,669,637,2637,1354,1283,2499,44,3,20,125,45353,557,1369.0,1478.0
1391,"Stevens County, Kansas",2837,246,202,141,173,251,304,111,20,189,20189,431,515,691,391,330,528,644,425,761,1043,1335,816,5603,2837,2766,4840,43,18,454,2040,57806,673,1891.0,1997.0
1392,"Smith County, Kansas",1796,85,88,60,103,78,111,65,20,183,20183,192,254,532,466,162,279,508,525,354,533,1040,991,3627,1796,1831,3499,12,27,0,81,43429,799,2042.0,2092.0
1393,"Grant County, Kansas",3888,345,397,235,246,417,317,95,20,67,20067,608,603,939,486,528,616,884,476,1136,1219,1823,962,7467,3888,3579,6597,3,32,785,3554,53413,975,2389.0,2452.0
1394,"Antrim County, Michigan",11582,560,636,456,443,510,632,435,26,9,26009,1304,1590,3476,2990,1191,1581,3633,3199,2495,3171,7109,6189,23206,11582,11624,22292,103,82,193,543,56165,5159,13582.0,17347.0
1395,"Houghton County, Michigan",19495,984,1083,629,900,1013,970,626,26,61,26061,6183,2696,3950,2890,3430,2554,3849,3233,9613,5250,7799,6123,36070,19495,16575,33634,278,1000,217,589,43183,6944,15624.0,18540.0
1396,"Livingston County, Michigan",95184,4974,5240,4376,4657,5572,5666,4086,26,93,26093,13459,16160,29645,14705,12140,15847,29935,16667,25599,32007,59580,31372,189754,95184,94570,182813,1135,1760,510,4630,84221,40722,105866.0,127162.0
1397,"Iosco County, Michigan",12546,582,532,388,545,669,486,364,26,69,26069,1447,1732,3744,3531,1230,1725,3840,3792,2677,3457,7584,7323,25197,12546,12651,24088,184,190,66,570,43678,5208,13361.0,15386.0
1398,"Lake County, Michigan",6053,281,288,177,232,255,277,175,26,85,26085,627,818,1886,1712,585,809,1890,1576,1212,1627,3776,3288,11852,6053,5799,10301,940,25,45,309,37320,2352,5328.0,6332.0
1399,"Manistee County, Michigan",12695,419,516,453,511,528,645,430,26,101,26101,1949,1940,3719,2929,1218,1596,3653,3181,3167,3536,7372,6110,24457,12695,11762,22297,710,92,87,772,50055,4847,12599.0,14654.0
1400,"Jackson County, Kansas",6627,441,421,304,428,418,470,295,20,85,20085,877,1085,1794,1166,789,1100,1807,1332,1666,2185,3601,2498,13266,6627,6639,11453,28,72,53,613,57914,2848,5818.0,6468.0
1401,"Kingman County, Kansas",3671,206,206,182,177,175,258,153,20,95,20095,426,533,1078,757,407,632,1024,843,833,1165,2102,1600,7340,3671,3669,7093,34,2,13,263,60469,1673,3334.0,3922.0
1402,"Logan County, Kansas",1408,115,72,48,82,65,114,79,20,109,20109,191,271,343,251,169,246,327,315,360,517,670,566,2805,1408,1397,2658,2,0,33,172,51740,490,1357.0,1437.0
1403,"Nemaha County, Kansas",5127,412,351,247,333,407,291,231,20,131,20131,693,832,1291,885,600,783,1242,1107,1293,1615,2533,1992,10121,5127,4994,9801,73,12,25,213,63216,2272,5122.0,5637.0
1404,"Pottawatomie County, Kansas",11934,851,1154,601,1011,1026,945,553,20,149,20149,1549,2473,2821,1596,1552,2337,2722,1767,3101,4810,5543,3363,23847,11934,11913,22485,313,186,152,1236,66835,5142,10693.0,12815.0
1405,"Wyandotte County, Kansas",81809,6889,6293,3470,6398,6913,5579,3442,20,209,20209,13599,16962,19114,8526,13637,16427,19342,11314,27236,33389,38456,19840,164861,81809,83052,96974,36685,7557,14911,47625,46881,23842,48781.0,55379.0
1406,"Cherokee County, Kansas",10014,570,903,398,540,632,664,469,20,21,20021,1307,1732,2727,1773,1244,1706,2844,2066,2551,3438,5571,3839,20179,10014,10165,18184,120,90,69,516,43175,3633,8620.0,8945.0
1407,"Butler County, Kansas",33771,2150,2251,1636,1817,2263,2612,1595,20,15,20015,5153,6504,8824,4447,4301,6093,8795,5451,9454,12597,17619,9898,66698,33771,32927,62026,1671,840,113,3256,64782,12795,27657.0,31946.0
1408,"Clay County, Kansas",4036,240,315,185,265,184,363,136,20,27,20027,436,772,995,839,408,661,1000,1029,844,1433,1995,1868,8082,4036,4046,7800,72,48,0,205,53929,1803,3820.0,4121.0
1409,"Lincoln County, Kansas",1561,80,78,101,65,78,134,25,20,105,20105,197,219,424,336,144,219,433,385,341,438,857,721,3044,1561,1483,2986,5,0,0,102,45076,636,1464.0,1570.0
1410,"Saline County, Kansas",27149,1834,1682,1096,1657,1713,1902,1046,20,169,20169,4447,4997,7016,4166,3857,4883,7248,5246,8304,9880,14264,9412,54701,27149,27552,47992,1536,1233,1365,6170,52200,11219,22064.0,24001.0
1411,"Sumner County, Kansas",11557,682,897,521,712,693,860,451,20,191,20191,1593,1959,3176,1862,1481,1862,3130,2368,3074,3821,6306,4230,23114,11557,11557,21726,237,150,124,1252,55000,4786,9722.0,10816.0
1412,"Trego County, Kansas",1422,67,59,54,37,41,107,73,20,195,20195,173,227,441,336,182,196,400,382,355,423,841,718,2840,1422,1418,2753,3,48,8,61,57966,588,1482.0,1603.0
1413,"Wabaunsee County, Kansas",3490,211,243,160,195,237,203,130,20,197,20197,416,520,1025,654,403,553,987,691,819,1073,2012,1345,6889,3490,3399,6537,37,88,34,265,61178,1617,3380.0,3861.0
1414,"Wilson County, Kansas",4261,285,240,194,300,232,330,172,20,205,20205,572,666,1159,813,471,661,1248,1013,1043,1327,2407,1826,8688,4261,4427,8222,40,1,6,279,48341,1685,3591.0,3899.0
1415,"Mitchell County, Kansas",3125,216,195,99,188,219,159,107,20,123,20123,554,474,744,653,364,443,741,799,918,917,1485,1452,6145,3125,3020,5963,44,17,8,150,46203,1261,2942.0,3039.0
1416,"Osborne County, Kansas",1765,111,90,66,96,99,106,59,20,141,20141,228,286,478,388,220,234,477,474,448,520,955,862,3530,1765,1765,3395,17,3,25,76,51286,746,1788.0,1904.0
1417,"Atchison County, Kansas",7844,429,557,353,490,455,567,348,20,5,20005,1475,1210,1972,1231,1818,1173,2052,1521,3293,2383,4024,2752,16268,7844,8424,14570,477,78,120,495,50439,3213,6575.0,7312.0
1418,"Finney County, Kansas",18897,1664,1741,927,1606,1558,1406,864,20,55,20055,3569,3444,4279,1762,3032,3227,4017,2143,6601,6671,8296,3905,36750,18897,17853,29758,1067,1509,3210,18340,60798,4389,10159.0,11506.0
1419,"Hamilton County, Kansas",1413,62,180,51,37,166,62,43,20,75,20075,191,326,296,194,114,311,288,157,305,637,584,351,2591,1413,1178,2356,138,0,82,854,46944,489,876.0,837.0
1420,"Leavenworth County, Kansas",43283,2692,2936,1752,2513,2356,2831,1435,20,103,20103,6808,10178,11043,5186,4972,7527,9620,6208,11780,17705,20663,11394,80745,43283,37462,66592,7124,1170,1659,5661,73013,16269,30301.0,36115.0
1421,"Washington County, Kansas",2807,198,141,106,168,169,147,95,20,201,20201,348,449,761,596,310,388,696,713,658,837,1457,1309,5493,2807,2686,5389,9,8,50,197,50588,1384,2765.0,2855.0
1422,"Wichita County, Kansas",999,49,85,41,65,84,38,116,20,203,20203,125,143,304,195,149,171,303,205,274,314,607,400,2130,999,1131,1896,20,14,152,750,57978,412,956.0,961.0
1423,"Morton County, Kansas",1375,65,200,32,67,51,80,115,20,129,20129,146,227,360,255,193,226,324,323,339,453,684,578,2754,1375,1379,2531,22,17,69,644,47750,513,1192.0,1163.0
1424,"Norton County, Kansas",3018,177,80,26,161,143,130,158,20,137,20137,521,699,822,511,259,326,645,606,780,1025,1467,1117,5446,3018,2428,5033,151,27,80,283,49038,1249,2234.0,2386.0
1425,"Barton County, Kansas",13040,887,939,502,726,949,800,570,20,9,20009,1965,2358,3238,2243,1978,2190,3457,2743,3943,4548,6695,4986,26453,13040,13413,24847,325,96,328,3918,49723,4769,10269.0,10980.0
1426,"Cloud County, Kansas",4452,325,327,177,286,301,248,174,20,29,20029,680,744,1145,783,637,657,1090,1093,1317,1401,2235,1876,8938,4452,4486,8513,175,8,70,283,45373,1825,3930.0,4179.0
1427,"Edwards County, Kansas",1430,101,85,36,73,60,146,70,20,47,20047,163,222,431,309,153,225,415,297,316,447,846,606,2869,1430,1439,2727,10,22,52,594,50902,539,1319.0,1413.0
1428,"Lane County, Kansas",798,58,35,59,45,74,44,24,20,101,20101,111,141,208,138,98,139,192,150,209,280,400,288,1564,798,766,1514,0,19,15,105,52125,294,871.0,888.0
1429,"Rush County, Kansas",1503,98,103,81,87,81,90,46,20,165,20165,167,232,399,349,146,233,434,402,313,465,833,751,3022,1503,1519,2882,6,17,11,98,47981,648,1503.0,1748.0
1430,"Marion County, Kansas",5994,334,394,228,274,350,379,232,20,115,20115,912,892,1607,1236,805,850,1552,1528,1717,1742,3159,2764,11964,5994,5970,11440,95,44,34,447,52123,2539,5624.0,5969.0
1431,"Neosho County, Kansas",7984,564,453,321,543,504,581,358,20,133,20133,1215,1301,2108,1358,1052,1290,2059,1737,2267,2591,4167,3095,16108,7984,8124,15280,208,11,25,897,46291,3009,6314.0,6629.0
1432,"Ottawa County, Kansas",2997,164,170,180,136,147,186,111,20,143,20143,376,502,828,537,274,496,855,620,650,998,1683,1157,5822,2997,2825,5600,57,42,0,158,54784,1247,2903.0,3161.0
1433,"Riley County, Kansas",39748,2123,1717,792,2089,1623,1520,1042,20,161,20161,18722,6628,5229,3011,13862,5819,5674,3679,32584,12447,10903,6690,75056,39748,35308,61781,4680,3801,1124,6250,51208,13195,21532.0,24024.0
1434,"Barber County, Kansas",2352,179,201,57,134,238,97,83,20,7,20007,312,333,700,456,271,336,571,542,583,669,1271,998,4624,2352,2272,4377,37,75,7,254,50174,940,2252.0,2313.0
1435,"Dickinson County, Kansas",9488,595,642,404,549,555,676,406,20,41,20041,1234,1834,2459,1672,1090,1602,2471,1991,2324,3436,4930,3663,18828,9488,9340,17852,259,100,68,881,49991,3828,8210.0,9246.0
1436,"Jefferson County, Kansas",9560,503,585,430,487,635,548,417,20,87,20087,1140,1606,2861,1693,1053,1596,2800,1794,2193,3202,5661,3487,18890,9560,9330,18097,137,3,62,517,64864,4640,8337.0,9545.0
1437,"Greenup County, Kentucky",17392,998,1084,707,899,1071,1035,611,21,89,21089,2452,3011,4731,3176,2161,3119,5230,4037,4613,6130,9961,7213,35555,17392,18163,34497,381,177,20,387,51655,7198,16277.0,18176.0
1438,"Fleming County, Kentucky",7152,496,517,304,559,425,498,297,21,69,21069,1003,1221,1990,1164,936,1243,2030,1373,1939,2464,4020,2537,14513,7152,7361,13961,318,13,44,157,44612,2736,6260.0,7066.0
1439,"Carter County, Kentucky",13345,867,782,523,792,633,1000,506,21,43,21043,2100,2299,3558,2268,2103,2251,3831,2698,4203,4550,7389,4966,27159,13345,13814,26608,152,29,14,369,34736,5404,10278.0,11585.0
1440,"Grant County, Kentucky",12323,873,939,534,892,1278,711,544,21,81,21081,1960,2320,3204,1591,1727,2326,3337,1813,3687,4646,6541,3404,24951,12323,12628,23820,199,31,442,694,48714,5302,9559.0,11106.0
1441,"Jefferson County, Kentucky",370951,24932,24905,14412,23605,21576,24419,13893,21,111,21111,62781,73963,95485,51224,62810,75707,104883,69575,125591,149670,200368,120799,767419,370951,396468,549506,166794,22040,7794,41742,56586,156810,353099.0,386093.0
1442,"Logan County, Kentucky",13127,904,835,517,820,735,961,595,21,141,21141,1884,2315,3503,2177,1885,2402,3659,2718,3769,4717,7162,4895,26902,13127,13775,24400,1806,69,179,767,48014,5596,10899.0,12346.0
1443,"Mason County, Kentucky",8490,514,736,331,510,490,496,304,21,161,21161,1338,1513,2285,1278,1141,1484,2486,1711,2479,2997,4771,2989,17112,8490,8622,15505,1082,155,46,328,45377,3388,7219.0,12394.0
1444,"Pendleton County, Kentucky",7422,482,461,341,408,496,401,285,21,191,21191,1054,1239,2265,1055,1000,1221,2132,1207,2054,2460,4397,2262,14572,7422,7150,14130,157,83,14,198,54375,3147,6007.0,6925.0
1445,"Robertson County, Kentucky",981,28,49,27,123,117,61,35,21,201,21201,124,181,316,189,103,169,267,267,227,350,583,456,2123,981,1142,2085,38,0,0,91,41902,411,1013.0,1146.0
1446,"Spencer County, Kentucky",9449,500,574,456,529,554,617,391,21,215,21215,1141,1784,3099,1221,1137,1849,2858,1296,2278,3633,5957,2517,18680,9449,9231,17966,347,63,51,445,80166,4023,9515.0,11429.0
1447,"Bath County, Kentucky",6142,442,513,310,388,294,608,242,21,11,21011,810,1047,1715,897,828,1082,1671,1100,1638,2129,3386,1997,12355,6142,6213,11921,188,58,17,206,44898,2375,4587.0,5627.0
1448,"Ballard County, Kentucky",3966,216,251,172,205,166,346,149,21,7,21007,549,673,1104,741,481,665,1129,925,1030,1338,2233,1666,8032,3966,4066,7452,328,19,9,109,45048,1678,4101.0,4225.0
1449,"Boyle County, Kentucky",15008,815,809,521,691,674,909,540,21,21,21021,2985,2726,3793,2336,2665,2257,4003,3225,5650,4983,7796,5561,29972,15008,14964,26229,2388,264,353,996,46382,5895,12946.0,14467.0
1450,"Green County, Kentucky",5381,250,286,237,338,290,331,199,21,87,21087,703,899,1636,984,647,984,1582,1227,1350,1883,3218,2211,10979,5381,5598,10447,285,9,0,94,35899,1903,5333.0,5812.0
1451,"Harlan County, Kentucky",12871,821,1021,515,859,882,814,477,21,95,21095,1775,2346,3573,2102,1853,2380,3887,2676,3628,4726,7460,4778,26699,12871,13828,25501,610,78,77,260,26478,4402,10757.0,10971.0
1452,"Martin County, Kentucky",6433,289,313,211,269,301,334,210,21,159,21159,1162,1678,1550,834,636,938,1534,993,1798,2616,3084,1827,11648,6433,5215,10837,636,11,45,231,41013,2100,3953.0,3930.0
1453,"Lincoln County, Kentucky",11984,863,889,478,762,920,671,504,21,137,21137,1679,2123,3316,1933,1615,2150,3437,2433,3294,4273,6753,4366,24476,11984,12492,23154,466,40,135,403,42919,4842,9561.0,10913.0
1454,"Monroe County, Kentucky",5332,349,307,210,329,256,343,182,21,171,21171,742,948,1502,853,672,909,1501,1103,1414,1857,3003,1956,10627,5332,5295,10166,265,31,68,328,34879,2125,4991.0,5330.0
1455,"Ohio County, Kentucky",11843,719,707,512,686,1050,905,446,21,183,21183,1650,2233,3132,1954,1490,2116,3243,2292,3140,4349,6375,4246,24071,11843,12228,23253,208,67,271,835,45564,4927,10398.0,11127.0
1456,"Union County, Kentucky",7644,380,477,313,418,321,372,202,21,225,21225,2034,1167,1900,1052,1209,1228,1926,1318,3243,2395,3826,2370,14638,7644,6994,12178,1950,68,75,288,46673,2788,6211.0,6576.0
1457,"Webster County, Kentucky",6479,360,439,244,424,463,422,257,21,233,21233,1024,1175,1791,1027,787,1164,1830,1242,1811,2339,3621,2269,13068,6479,6589,11891,474,7,243,715,42119,2468,5805.0,5991.0
1458,"Jim Wells County, Texas",20117,1463,1563,975,1646,1657,1485,926,48,249,48249,3407,3762,4423,2776,3139,3875,4790,3337,6546,7637,9213,6113,40972,20117,20855,39004,271,216,875,32893,41505,6463,12379.0,13507.0
1459,"Dallam County, Texas",3718,336,265,165,356,397,297,114,48,111,48111,642,577,974,387,576,551,898,397,1218,1128,1872,784,7304,3718,3586,6550,56,142,311,3347,58811,1073,1544.0,1605.0
1460,"Montmorency County, Michigan",4673,149,170,146,169,166,226,117,26,119,26119,406,588,1510,1466,418,540,1515,1441,824,1128,3025,2907,9265,4673,4592,8951,22,14,17,122,41772,2192,5009.0,5863.0
1461,"Presque Isle County, Michigan",6329,236,268,218,259,248,320,220,26,141,26141,592,802,1989,1937,573,806,2004,1955,1165,1608,3993,3892,12714,6329,6385,12276,75,72,36,177,47948,2773,7218.0,8360.0
1462,"Gladwin County, Michigan",12744,704,728,461,628,618,610,450,26,51,26051,1455,1807,3725,3218,1327,1679,3786,3437,2782,3486,7511,6655,25279,12744,12535,24513,78,131,42,428,44619,5172,12472.0,14603.0
1463,"Kalamazoo County, Michigan",128538,8018,7699,4931,7846,7735,7714,4655,26,77,26077,30058,23433,29268,16666,29927,23335,31306,21689,59985,46768,60574,38355,262745,128538,134207,212216,29215,6259,1754,12975,56511,52298,126299.0,143640.0
1464,"Mecosta County, Michigan",21810,1099,1137,765,979,908,1287,745,26,107,26107,5826,3013,5171,3662,4993,2987,5382,4160,10819,6000,10553,7822,43251,21810,21441,40183,1296,370,132,992,45018,8140,17168.0,21077.0
1465,"Marquette County, Michigan",33610,1563,1918,1031,1625,1599,1682,986,26,103,26103,7127,5730,8698,5930,7074,5307,8444,6359,14201,11037,17142,12289,66686,33610,33076,62152,1118,627,141,1016,53970,14359,32976.0,37553.0
1466,"Newaygo County, Michigan",24285,1379,1529,1030,1407,1363,1629,943,26,123,26123,3354,4032,6933,4371,3115,3894,6989,4741,6469,7926,13922,9112,48366,24285,24081,44979,595,186,1314,2803,50326,9730,22640.0,27164.0
1467,"Osceola County, Michigan",11804,688,752,551,605,639,740,499,26,133,26133,1567,1844,3304,2292,1435,1839,3218,2511,3002,3683,6522,4803,23290,11804,11486,22388,261,64,32,454,44032,4916,10609.0,12340.0
1468,"Otsego County, Michigan",12153,677,763,514,593,720,754,455,26,137,26137,1719,1890,3530,2380,1595,1913,3611,2696,3314,3803,7141,5076,24490,12153,12337,23442,163,139,37,423,54332,5094,12538.0,14756.0
1469,"Calhoun County, Michigan",65779,4332,4085,2865,3971,4156,4186,2578,26,25,26025,10415,11515,17608,10249,10277,11905,18379,12981,20692,23420,35987,23230,134212,65779,68433,109110,14148,3233,924,7031,48607,26123,58902.0,65568.0
1470,"Cheboygan County, Michigan",12713,543,502,427,475,492,645,435,26,31,26031,1509,1830,3883,3281,1379,1797,3961,3521,2888,3627,7844,6802,25418,12713,12705,23683,205,111,52,366,48044,5574,13672.0,15849.0
1471,"Luce County, Michigan",3756,122,160,140,142,154,127,51,26,95,26095,615,849,1039,681,286,394,755,673,901,1243,1794,1354,6338,3756,2582,5043,429,32,32,221,45469,1312,2579.0,3107.0
1472,"Kent County, Michigan",319318,22485,22709,13503,21426,21339,21330,13081,26,81,26081,58058,64014,78403,37806,57662,64343,81524,48098,115720,128357,159927,85904,648121,319318,328803,515653,62188,19427,21917,68519,63053,127658,308184.0,359915.0
1473,"Saginaw County, Michigan",93128,5662,5850,3802,5361,5780,5356,3688,26,145,26145,15838,15650,24867,15628,15494,15908,26933,20173,31332,31558,51800,35801,191821,93128,98693,144268,35664,2284,2767,16218,48000,33782,94320.0,103347.0
1474,"Shiawassee County, Michigan",33776,1791,2115,1422,1784,1854,2060,1476,26,155,26155,5094,5866,9908,5483,4755,5797,10172,6666,9849,11663,20080,12149,68340,33776,34564,65997,467,200,168,2011,56032,13218,34111.0,39250.0
1475,"Bay County, Michigan",51139,2565,3144,2044,2560,2773,3079,1932,26,17,26017,7615,9022,14569,8999,7160,8797,15252,11412,14775,17819,29821,20411,104104,51139,52965,98568,1796,606,377,5548,48819,20681,52977.0,53505.0
1476,"Charlevoix County, Michigan",12974,575,701,477,579,716,749,501,26,29,26029,1644,1934,3920,2963,1487,1899,4042,3241,3131,3833,7962,6204,26188,12974,13214,24951,122,129,23,523,55760,5836,14589.0,17023.0
1477,"Delta County, Michigan",17924,966,958,706,843,973,979,650,26,41,26041,2158,2806,5281,3923,2102,2800,5261,4494,4260,5606,10542,8417,36026,17924,18102,33746,121,156,37,493,47434,7265,18492.0,21154.0
1478,"Emmet County, Michigan",16359,874,851,660,729,671,1023,651,26,47,26047,2296,2664,4678,3338,2131,2791,4895,3854,4427,5455,9573,7192,33104,16359,16745,30573,246,205,71,549,55829,7101,18802.0,22176.0
1479,"Koochiching County, Minnesota",6238,259,392,243,249,305,353,221,27,71,27071,762,909,1970,1435,689,927,1914,1619,1451,1836,3884,3054,12515,6238,6277,11711,73,49,111,168,50870,2582,6363.0,6920.0
1480,"Morrison County, Minnesota",16679,978,1118,713,943,1162,1006,600,27,97,27097,2146,2933,4686,2884,1966,2765,4560,3383,4112,5698,9246,6267,33064,16679,16385,31845,185,144,345,577,57815,7110,17614.0,19517.0
1481,"Pennington County, Minnesota",7055,437,536,281,497,382,485,275,27,113,27113,1042,1349,1873,1117,994,1276,1791,1428,2036,2625,3664,2545,14183,7055,7128,13329,153,165,33,537,60122,2430,6715.0,7262.0
1482,"Steele County, Minnesota",18200,1023,1208,820,1267,1331,1371,703,27,147,27147,2633,3283,4961,2794,2133,3463,4757,3458,4766,6746,9718,6252,36683,18200,18483,33193,1158,547,1222,2860,64903,7348,19179.0,20806.0
1483,"Wilkin County, Minnesota",3245,190,202,154,177,176,193,112,27,167,27167,412,536,975,552,365,523,871,629,777,1059,1846,1181,6291,3245,3046,6181,25,1,8,22,60595,1286,3302.0,3435.0
1484,"Aitkin County, Minnesota",8047,314,516,260,255,333,395,244,27,1,27001,713,968,2355,2587,682,959,2362,2557,1395,1927,4717,5144,15834,8047,7787,15003,81,54,41,221,49351,3499,9231.0,10005.0
1485,"Faribault County, Minnesota",6920,427,442,299,395,398,394,249,27,43,27043,825,1122,1994,1379,743,1063,1884,1755,1568,2185,3878,3134,13801,6920,6881,13350,35,51,130,954,53156,2938,7412.0,7885.0
1486,"Murray County, Minnesota",4149,225,281,142,213,244,270,150,27,101,27101,465,619,1143,1018,457,593,1135,1085,922,1212,2278,2103,8296,4149,4147,8002,31,132,31,335,60231,1878,4668.0,4882.0
1487,"Kandiyohi County, Minnesota",21565,1513,1676,915,1389,1289,1639,681,27,67,27067,3306,3725,5470,3615,2890,3594,5555,4239,6196,7319,11025,7854,42841,21565,21276,37829,2285,444,1377,5190,60294,7266,21772.0,23301.0
1488,"Lake County, Minnesota",5424,267,307,168,222,242,265,150,27,75,27075,542,855,1695,1357,544,807,1545,1361,1086,1662,3240,2718,10560,5424,5136,10234,68,14,9,151,61452,2499,6521.0,7200.0
1489,"Rock County, Minnesota",4601,296,288,209,335,367,344,190,27,133,27133,624,766,1203,849,559,771,1218,1017,1183,1537,2421,1866,9402,4601,4801,9064,87,100,22,299,63005,2099,4839.0,5232.0
1490,"Roseau County, Minnesota",7910,477,547,357,420,532,540,324,27,135,27135,1062,1321,2374,1217,919,1225,2146,1345,1981,2546,4520,2562,15361,7910,7451,14214,146,416,32,202,62202,2978,7804.0,8390.0
1491,"Traverse County, Minnesota",1644,85,90,53,75,100,86,84,27,155,27155,243,245,476,373,181,238,454,449,424,483,930,822,3311,1644,1667,3003,17,6,36,103,51957,662,1798.0,1864.0
1492,"Becker County, Minnesota",16928,1074,1284,727,1089,1288,1082,702,27,5,27005,2075,2861,4591,3266,2102,2763,4447,3610,4177,5624,9038,6876,34011,16928,17083,29783,167,219,118,716,60284,6726,17222.0,19471.0
1493,"Hennepin County, Minnesota",616042,41213,39103,21920,39586,38520,35743,21147,27,53,27053,108367,138065,155333,74533,105859,134132,158923,95885,214226,272197,314256,170418,1245837,616042,629795,897639,165152,89004,37947,86179,78167,302769,679977.0,753716.0
1494,"Brown County, Minnesota",12610,751,799,474,639,703,737,459,27,15,27015,1822,2203,3297,2364,1809,1989,3338,2879,3631,4192,6635,5243,25163,12610,12553,24021,181,166,531,1107,61120,5191,13779.0,14623.0
1495,"Chippewa County, Minnesota",5912,462,372,204,386,379,362,214,27,23,27023,829,1010,1504,1121,787,963,1575,1375,1616,1973,3079,2496,11953,5912,6041,10775,103,105,497,872,55269,2309,6222.0,6611.0
1496,"Clearwater County, Minnesota",4514,296,309,204,256,264,332,176,27,29,27029,560,762,1159,870,487,708,1166,918,1047,1470,2325,1788,8821,4514,4307,7568,16,42,18,191,50386,1632,4245.0,4705.0
1497,"Goodhue County, Minnesota",22975,1336,1440,1023,1286,1413,1540,810,27,49,27049,3030,4103,6525,4006,2715,4131,6602,4774,5745,8234,13127,8780,46246,22975,23271,43474,606,383,468,1547,66800,10043,25717.0,28563.0
1498,"Isanti County, Minnesota",19973,1216,1352,814,1126,1251,1365,776,27,59,27059,2748,3859,5671,2809,2602,3623,5401,3313,5350,7482,11072,6122,39430,19973,19457,37510,192,576,202,801,74616,8294,21016.0,24162.0
1499,"Jackson County, Minnesota",5089,297,267,206,266,268,290,202,27,63,27063,619,886,1474,987,557,805,1312,1165,1176,1691,2786,2152,9954,5089,4865,9403,39,208,132,362,58727,2125,5484.0,5809.0
1500,"Mower County, Minnesota",20058,1333,1552,896,1255,1459,1264,756,27,99,27099,2795,3829,5043,3180,2575,3525,4789,4126,5370,7354,9832,7306,39807,20058,19749,34533,1570,1468,1091,4611,54295,7716,17715.0,19441.0
1501,"Pine County, Minnesota",15601,741,850,556,631,759,839,527,27,115,27115,2055,2970,4679,2843,1537,2236,4062,3031,3592,5206,8741,5874,29223,15601,13622,26701,658,164,144,853,53422,6254,13811.0,15998.0
1502,"Olmsted County, Minnesota",75648,5492,5396,3029,5328,5342,5060,3018,27,109,27109,11168,15931,18886,10282,11612,15861,19874,13066,22780,31792,38760,23348,154809,75648,79161,129616,9566,9028,1513,7626,76951,37068,80129.0,91074.0
1503,"Wadena County, Minnesota",6739,522,537,275,414,455,517,300,27,159,27159,841,1080,1778,1271,890,1070,1677,1592,1731,2150,3455,2863,13654,6739,6915,12982,82,57,104,267,46605,2540,6934.0,7656.0
1504,"Benton County, Minnesota",20130,1410,1441,738,1397,1361,1499,790,27,9,27009,3154,4443,4994,2442,3067,4128,4672,3085,6221,8571,9666,5527,40129,20130,19999,36637,1601,408,326,981,57715,7829,20058.0,22211.0
1505,"Freeborn County, Minnesota",15155,848,992,581,846,1024,847,553,27,47,27047,1864,2588,4258,3029,1840,2486,4042,3670,3704,5074,8300,6699,30463,15155,15308,27894,330,777,729,2967,53631,5481,16051.0,16813.0
1506,"Itasca County, Minnesota",22863,1302,1585,937,1086,1240,1340,808,27,61,27061,2744,3671,6540,4896,2417,3581,6486,5320,5161,7252,13026,10216,45141,22863,22278,41877,222,192,81,674,55139,8750,23880.0,26502.0
1507,"Pope County, Minnesota",5587,324,374,220,302,312,302,169,27,121,27121,643,969,1515,1226,593,882,1508,1393,1236,1851,3023,2619,11048,5587,5461,10666,46,63,82,173,61275,2199,6319.0,7019.0
1508,"Stevens County, Minnesota",4908,302,280,197,252,260,324,140,27,149,27149,1222,807,1031,751,1255,741,1011,898,2477,1548,2042,1649,9789,4908,4881,8846,195,232,229,631,60559,1942,5398.0,5063.0
1509,"Swift County, Minnesota",4686,276,321,187,258,240,333,171,27,151,27151,566,807,1295,907,514,819,1201,1137,1080,1626,2496,2044,9359,4686,4673,8845,206,27,144,467,51620,1832,4994.0,5185.0
1510,"Cottonwood County, Minnesota",5650,389,403,256,385,409,315,193,27,33,27033,684,846,1509,1169,647,879,1422,1399,1331,1725,2931,2568,11299,5650,5649,10101,107,450,453,870,52087,2343,5721.0,6095.0
1511,"Scott County, Minnesota",72365,5114,5845,3544,5033,5588,5893,3508,27,139,27139,9579,15555,19790,6988,9421,15832,19486,8149,19000,31387,39276,15137,145275,72365,72910,121973,6199,8845,3347,7466,102152,30673,75029.0,87664.0
1512,"Wabasha County, Minnesota",10849,611,600,427,574,614,673,381,27,157,27157,1274,1825,3172,2191,1299,1680,3096,2371,2573,3505,6268,4562,21537,10849,10688,20773,126,103,219,630,65226,4712,11832.0,13088.0
1513,"Pipestone County, Minnesota",4484,282,387,197,329,264,340,199,27,117,27117,526,730,1234,781,592,680,1181,1122,1118,1410,2415,1903,9191,4484,4707,8460,120,15,152,636,52917,1844,4808.0,4932.0
1514,"Norman County, Minnesota",3320,171,232,159,186,182,226,139,27,107,27107,394,538,916,668,356,519,864,728,750,1057,1780,1396,6520,3320,3200,6080,65,26,44,332,55085,1266,3261.0,3434.0
1515,"Nicollet County, Minnesota",17018,1056,1152,613,926,1025,1187,642,27,103,27103,3360,3232,4262,2475,3197,3197,3920,2842,6557,6429,8182,5317,33954,17018,16936,31228,958,592,288,1548,67399,7262,18097.0,19118.0
1516,"Fort Bend County, Texas",375912,26899,30860,18990,25919,29039,29966,18574,48,157,48157,53418,80062,96960,37301,53075,87622,101242,44045,106493,167684,198202,81346,765394,375912,389482,395904,157134,154513,33215,187500,97743,188472,262066.0,357833.0
1517,"Irion County, Texas",838,27,114,14,39,55,95,21,48,235,48235,169,99,228,127,92,102,232,146,261,201,460,273,1620,838,782,1233,66,0,307,414,47500,226,766.0,889.0
1518,"Willacy County, Texas",11663,693,545,450,695,719,747,389,48,489,48489,2936,2527,2232,1324,1912,1700,2133,1630,4848,4227,4365,2954,21588,11663,9925,20975,138,0,271,19039,35521,3412,5095.0,5575.0
1519,"Dawson County, Texas",6939,454,354,210,451,448,450,320,48,115,48115,1611,1456,1394,817,839,1009,1296,1061,2450,2465,2690,1878,12813,6939,5874,9638,1036,24,1450,7363,43239,1699,3563.0,3789.0
1520,"Burleson County, Texas",8951,526,579,395,553,479,521,356,48,51,48051,1242,1451,2425,1727,1230,1481,2525,1962,2472,2932,4950,3689,18058,8951,9107,14421,2395,7,749,3736,57731,3492,6960.0,8604.0
1521,"Nueces County, Texas",178516,12515,12887,7955,11896,12209,12000,7531,48,355,48355,32213,35713,42168,22520,31196,35412,44417,28363,63409,71125,86585,50883,361540,178516,183024,325660,13542,7501,6902,230450,55919,61925,104405.0,126984.0
1522,"Rains County, Texas",5912,305,340,228,287,226,329,200,48,379,48379,638,943,1669,1410,709,893,1727,1483,1347,1836,3396,2893,11766,5912,5854,10505,415,42,595,1073,51579,2550,4701.0,6044.0
1523,"Real County, Texas",1498,133,85,79,97,166,160,74,48,385,48385,178,121,380,439,237,224,416,536,415,345,796,975,3408,1498,1910,3245,19,2,141,895,35862,520,1681.0,1982.0
1524,"Sterling County, Texas",678,38,88,103,39,64,32,6,48,431,48431,51,58,235,51,36,127,144,105,87,185,379,156,1231,678,553,1122,0,0,97,641,59868,230,633.0,639.0
1525,"Carson County, Texas",2897,219,195,129,200,202,236,134,48,65,48065,327,554,785,527,455,566,748,571,782,1120,1533,1098,6009,2897,3112,5657,48,22,60,596,74872,1328,2964.0,3081.0
1526,"Freestone County, Texas",10203,555,612,448,582,755,403,431,48,161,48161,1269,2157,2709,1753,1112,1725,2390,2113,2381,3882,5099,3866,19714,10203,9511,15857,2995,139,298,3055,49471,3248,7684.0,8678.0
1527,"Hardeman County, Texas",1918,92,81,42,106,130,136,88,48,197,48197,316,312,532,398,245,340,535,447,561,652,1067,845,3945,1918,2027,3469,232,0,108,749,41859,649,1513.0,1580.0
1528,"Briscoe County, Texas",804,34,32,17,18,35,33,28,48,45,48045,149,129,210,193,102,95,163,179,251,224,373,372,1457,804,653,1256,12,0,26,519,40227,226,736.0,724.0
1529,"Liberty County, Texas",41320,3069,2795,1875,2900,2853,3128,1800,48,291,48291,6930,7801,10374,5042,6887,8496,10487,5831,13817,16297,20861,10873,83702,41320,42382,67404,8273,439,6215,20788,51494,11957,24267.0,29314.0
1530,"Loving County, Texas",54,5,4,0,16,0,0,0,48,301,48301,2,16,15,12,5,0,10,13,7,16,25,25,98,54,44,95,0,0,0,12,83750,9,65.0,66.0
1531,"Robertson County, Texas",8315,632,519,280,469,590,513,391,48,395,48395,1167,1236,2311,1523,1193,1428,2385,1706,2360,2664,4696,3229,16990,8315,8675,12988,3474,31,218,3564,52928,2814,7035.0,8080.0
1532,"Rusk County, Texas",28614,1560,1814,1051,1530,1780,1671,1043,48,401,48401,5101,5937,7390,4061,3272,4724,6352,4769,8373,10661,13742,8830,53755,28614,25141,41975,9075,279,902,9042,55234,8460,18994.0,21367.0
1533,"Trinity County, Texas",7022,353,481,238,376,443,474,239,48,455,48455,877,916,1932,1841,759,1171,2144,1992,1636,2087,4076,3833,14620,7022,7598,12557,1454,5,305,1460,41357,2387,5985.0,6938.0
1534,"Bandera County, Texas",11192,634,453,339,316,505,444,379,48,19,48019,1185,1605,3290,2947,1111,1528,3814,2926,2296,3133,7104,5873,22215,11192,11023,19990,154,62,288,4175,58661,4608,10218.0,12703.0
1535,"Childress County, Texas",4442,246,207,102,54,220,212,49,48,75,48075,1278,1238,814,361,392,560,681,643,1670,1798,1495,1004,7253,4442,2811,6189,583,76,241,2249,43181,1499,2084.0,2259.0
1536,"Comal County, Texas",69980,4243,4201,2954,3941,4094,4782,2893,48,91,48091,9305,12625,19707,11862,9073,12747,20597,13535,18378,25372,40304,25397,141642,69980,71662,128737,2901,1597,4655,38756,79936,31148,62178.0,87942.0
1537,"Houston County, Texas",12452,590,799,477,582,616,605,314,48,225,48225,1572,2611,3599,2289,1267,1656,2858,2604,2839,4267,6457,4893,22954,12452,10502,16003,5888,88,473,2544,37904,3433,8353.0,9426.0
1538,"Navarro County, Texas",24098,1786,1946,1099,1790,1274,2149,1072,48,349,48349,3731,3996,6080,3721,3510,4358,6236,4508,7241,8354,12316,8229,48995,24098,24897,36379,5985,333,3210,13354,48529,6550,16433.0,19105.0
1539,"Scurry County, Texas",9277,562,601,394,581,441,797,250,48,415,48415,1593,2112,2206,1136,1152,1394,1762,1442,2745,3506,3968,2578,17096,9277,7819,14721,792,51,1003,6904,54326,2952,5289.0,5865.0
1540,"Stonewall County, Texas",720,30,37,42,94,22,62,32,48,433,48433,98,53,214,167,41,117,255,133,139,170,469,300,1476,720,756,1363,30,0,33,314,51250,256,701.0,736.0
1541,"Bastrop County, Texas",42810,2793,3011,1896,2726,2474,3420,2037,48,21,48021,6380,8084,11767,5670,5749,7131,11542,6633,12129,15215,23309,12303,84522,42810,41712,57462,6298,739,17393,31852,64597,13570,28454.0,36709.0
1542,"Bee County, Texas",19915,947,849,604,954,892,1000,561,48,25,48025,4389,5468,4777,1786,1997,2239,2934,2119,6386,7707,7711,3905,32611,19915,12696,28172,2399,176,561,19194,44578,5158,8485.0,9405.0
1543,"Crane County, Texas",2458,185,213,150,200,148,243,89,48,103,48103,408,442,577,243,335,444,474,411,743,886,1051,654,4802,2458,2344,2543,129,95,2020,3091,65969,450,1384.0,1503.0
1544,"Rutland County, Vermont",28933,1302,1287,1025,1318,1433,1481,981,50,21,50021,4534,4557,8791,5728,4213,4559,9155,6819,8747,9116,17946,12547,58892,28933,29959,56865,517,672,111,864,56139,15849,29619.0,33946.0
1545,"Orange County, Vermont",14418,707,719,531,662,749,638,474,50,17,50017,1989,2433,4427,2746,1812,2404,4571,3180,3801,4837,8998,5926,28908,14418,14490,27937,200,66,56,386,60925,7948,14649.0,17101.0
1546,"Windsor County, Vermont",27097,1299,1280,918,1163,1433,1377,978,50,27,50027,3330,4483,8275,5876,3150,4638,8758,6681,6480,9121,17033,12557,55275,27097,28178,52867,406,482,348,929,60987,15653,29928.0,34507.0
1547,"Utah County, Utah",305954,29967,29608,16480,27997,27875,27697,15664,49,49,49049,76417,57967,45271,20983,73010,56939,45541,24813,149427,114906,90812,45796,605490,305954,299536,554930,3499,9193,10774,71315,74665,80910,201551.0,259688.0
1548,"Duchesne County, Utah",10280,1021,954,549,912,974,926,524,49,13,49013,1463,2132,2074,1124,1404,2000,1958,1170,2867,4132,4032,2294,20148,10280,9868,18063,90,107,609,1650,63224,3119,6942.0,8476.0
1549,"Uintah County, Utah",18302,1682,1842,957,1505,2044,1423,888,49,47,49047,2882,4085,3416,1736,2661,3897,3428,1936,5543,7982,6844,3672,36084,18302,17782,31684,144,165,431,3038,65264,4746,12797.0,14796.0
1550,"Davis County, Utah",174378,15495,16848,9338,14294,15472,15546,8752,49,11,49011,28855,37788,33934,15599,26941,37909,34318,18157,55796,75697,68252,33756,345767,174378,171389,311855,4603,6143,7618,33434,83310,53589,138411.0,147774.0
1551,"Emery County, Utah",5168,338,547,254,317,389,421,269,49,15,49015,663,908,1156,827,608,924,1187,834,1271,1832,2343,1661,10117,5168,4949,9848,2,68,0,642,55554,1441,4289.0,4816.0
1552,"Garfield County, Utah",2524,140,150,103,173,168,151,125,49,17,49017,313,457,632,544,347,362,604,544,660,819,1236,1088,4998,2524,2474,4649,10,4,74,306,54565,1009,2344.0,2722.0
1553,"Isle of Wight County, Virginia",17941,963,1145,694,929,1121,1024,692,51,93,51093,2376,3196,5400,3079,2183,3228,5774,3735,4559,6424,11174,6814,36627,17941,18686,26425,8248,349,408,1118,73991,6973,21075.0,23330.0
1554,"Franklin city, Virginia",3640,261,365,118,285,371,214,169,51,620,51620,490,737,725,676,466,839,1268,895,956,1576,1993,1571,8147,3640,4507,3003,4618,103,90,90,40417,1135,4070.0,4031.0
1555,"Lexington city, Virginia",4112,27,39,91,140,123,65,96,51,678,51678,2719,323,439,406,1093,222,668,722,3812,545,1107,1128,7241,4112,3129,6063,637,250,86,443,42632,1039,2465.0,2731.0
1556,"Henry County, Virginia",24817,1291,1422,945,1113,1419,1353,868,51,89,51089,3130,3856,7317,5271,3052,4016,7837,6833,6182,7872,15154,12104,51308,24817,26491,37232,11649,322,1147,2823,37952,7726,24106.0,25936.0
1557,"King William County, Virginia",8160,458,715,332,462,534,519,307,51,101,51101,1257,1568,2213,1168,1209,1597,2451,1449,2466,3165,4664,2617,16688,8160,8528,13181,2741,201,20,442,66987,3429,9161.0,10733.0
1558,"Louisa County, Virginia",17679,999,1184,605,1007,1135,983,568,51,109,51109,2266,3101,5327,3329,2220,3160,5563,3725,4486,6261,10890,7054,36040,17679,18361,28710,5359,208,420,1059,60975,6989,17631.0,21914.0
1559,"Prince Edward County, Virginia",11329,583,414,401,476,487,658,289,51,147,51147,3965,1601,2406,1571,3481,1569,2504,2112,7446,3170,4910,3683,22905,11329,11576,14724,7068,194,276,954,47202,3633,9143.0,9543.0
1560,"Rockingham County, Virginia",39392,2314,2388,1723,2219,2336,2541,1552,51,165,51165,5949,6812,10577,6874,6110,6829,11066,8239,12059,13641,21643,15113,80284,39392,40892,74651,2428,578,700,5567,61864,17758,37487.0,38622.0
1561,"Calloway County, Kentucky",18835,953,933,564,1025,1035,907,588,21,35,21035,4916,3015,4480,2940,5108,3061,4682,3596,10024,6076,9162,6536,38837,18835,20002,35515,1369,426,177,1055,42273,7572,16049.0,17453.0
1562,"Casey County, Kentucky",7749,486,509,334,454,496,470,334,21,45,21045,1128,1309,2098,1365,1068,1422,2095,1797,2196,2731,4193,3162,15885,7749,8136,15418,126,38,42,466,34819,2989,6439.0,7240.0
1563,"Christian County, Kentucky",37966,3502,2937,1266,3170,2526,2399,1256,21,47,21047,11872,6337,6072,3708,6478,6111,6605,4903,18350,12448,12677,8611,71414,37966,33448,50879,15683,1167,678,5621,43919,10134,22083.0,23863.0
1564,"Daviess County, Kentucky",49081,3546,3463,2074,3227,3102,3663,1909,21,59,21059,7392,9178,12661,7256,7415,9250,13304,9523,14807,18428,25965,16779,100474,49081,51393,90657,4372,1767,612,3146,51673,19528,45807.0,49240.0
1565,"Grayson County, Kentucky",13073,830,938,570,801,707,972,571,21,85,21085,1883,2345,3538,2098,1849,2333,3516,2425,3732,4678,7054,4523,26247,13073,13174,25179,303,16,246,362,38612,4904,10576.0,11994.0
1566,"Henderson County, Kentucky",22133,1451,1437,845,1285,1466,1579,880,21,101,21101,3338,4020,6031,3467,3113,4391,6560,4422,6451,8411,12591,7889,45829,22133,23696,40333,3345,194,510,1170,48926,8729,19710.0,20697.0
1567,"Henry County, Kentucky",7910,494,583,360,449,384,604,313,21,103,21103,1134,1379,2181,1222,999,1417,2352,1483,2133,2796,4533,2705,15911,7910,8001,14844,472,100,187,518,53926,2979,7149.0,8107.0
1568,"Hopkins County, Kentucky",22126,1356,1685,963,1314,1265,1557,830,21,107,21107,3116,3998,5999,3559,3060,4098,6483,4598,6176,8096,12482,8157,45331,22126,23205,40802,2916,269,166,949,47170,9071,20345.0,21512.0
1569,"Jackson County, Kentucky",6632,418,403,289,396,358,444,242,21,109,21109,916,1259,1867,1020,832,1254,1957,1254,1748,2513,3824,2274,13369,6632,6737,13111,42,0,0,33,32138,2844,5501.0,6116.0
1570,"Laurel County, Kentucky",29539,1864,1634,1337,1818,1949,1779,1262,21,125,21125,4401,5625,7960,4404,4360,5793,8570,5287,8761,11418,16530,9691,60357,29539,30818,58536,444,237,122,940,41526,11833,24833.0,28097.0
1571,"Marshall County, Kentucky",15218,838,1013,579,899,883,810,552,21,157,21157,1981,2566,4327,3084,1876,2799,4477,3678,3857,5365,8804,6762,31192,15218,15974,30380,293,62,50,514,55113,6959,16698.0,17609.0
1572,"Meade County, Kentucky",14232,796,1185,634,711,1017,783,582,21,163,21163,2160,2851,3924,1932,2091,2837,3924,2005,4251,5688,7848,3937,28182,14232,13950,25861,1061,185,162,1040,56603,5586,12231.0,14110.0
1573,"Montgomery County, Kentucky",13737,1019,957,584,832,971,798,523,21,173,21173,2081,2541,3638,1926,1996,2670,3887,2470,4077,5211,7525,4396,27884,13737,14147,26342,780,21,189,768,45516,5546,11452.0,12837.0
1574,"Nicholas County, Kentucky",3439,218,273,74,250,211,243,208,21,181,21181,511,598,989,554,499,624,1027,652,1010,1222,2016,1206,7153,3439,3714,6872,114,0,41,103,38149,1378,2841.0,3396.0
1575,"Oldham County, Kentucky",34554,1606,2039,1756,1759,2366,2611,1676,21,185,21185,4962,7454,9724,3955,3668,5960,8944,4429,8630,13414,18668,8384,65967,34554,31413,60313,2437,1028,336,2613,99128,14076,32853.0,37936.0
1576,"Douglas County, Minnesota",18768,1073,1050,658,1054,1168,1160,614,27,41,27041,2522,3293,4955,3930,2204,3003,5052,4490,4726,6296,10007,8420,37513,18768,18745,36341,145,121,207,620,63819,7326,21785.0,24106.0
1577,"Grant County, Minnesota",3001,178,198,100,169,174,221,92,27,51,27051,340,524,793,671,308,470,789,711,648,994,1582,1382,5935,3001,2934,5743,17,2,24,137,55466,1190,3473.0,3647.0
1578,"Kittson County, Minnesota",2169,131,144,86,113,115,141,89,27,69,27069,257,317,650,475,230,284,613,557,487,601,1263,1032,4311,2169,2142,4150,64,29,4,40,59643,1015,2385.0,2638.0
1579,"Le Sueur County, Minnesota",14153,893,857,583,843,940,1010,584,27,79,27079,1768,2615,4102,2253,1714,2568,3854,2576,3482,5183,7956,4829,28242,14153,14089,26972,238,115,468,1755,71080,6435,14971.0,16772.0
1580,"Owen County, Kentucky",5368,287,466,231,263,493,236,224,21,187,21187,709,945,1583,914,688,957,1550,1017,1397,1902,3133,1931,10796,5368,5428,10668,62,0,0,41,48801,2152,5001.0,5456.0
1581,"Rockcastle County, Kentucky",8155,466,507,369,470,574,524,318,21,203,21203,1151,1395,2469,1316,1091,1537,2473,1678,2242,2932,4942,2994,16820,8155,8665,16489,26,23,1,156,35720,3430,6691.0,7784.0
1582,"Scott County, Kentucky",26941,1814,1888,1240,1780,2143,1911,1031,21,209,21209,4455,5732,6872,2878,4262,6085,6912,3602,8717,11817,13784,6480,54667,26941,27726,48003,2528,650,1533,2366,70817,10833,24200.0,28950.0
1583,"Warren County, Kentucky",62979,4149,3642,2406,4125,3837,4177,2369,21,227,21227,15432,11658,13922,7252,15352,11851,14931,9031,30784,23509,28853,16283,128652,62979,65673,104990,11459,5151,2362,6898,52270,23010,48454.0,55351.0
1584,"Allen County, Kentucky",10456,750,696,415,602,647,777,403,21,3,21003,1427,1921,2869,1686,1509,1751,2857,1942,2936,3672,5726,3628,20944,10456,10488,20213,208,130,66,452,44036,4399,8096.0,15951.0
1585,"Bourbon County, Kentucky",9618,581,668,395,654,617,685,353,21,17,21017,1448,1657,2655,1632,1369,1730,2864,2168,2817,3387,5519,3800,20058,9618,10440,18128,1401,162,279,1364,49637,3676,8803.0,9643.0
1586,"Bullitt County, Kentucky",40070,2148,2486,1821,1936,2051,2694,1640,21,29,21029,5939,7675,11355,5716,5840,7889,11485,6566,11779,15564,22840,12282,80171,40070,40101,76851,886,580,413,1608,63348,16849,36069.0,41964.0
1587,"Crittenden County, Kentucky",4595,250,234,196,237,237,292,164,21,55,21055,593,815,1228,867,516,733,1272,954,1109,1548,2500,1821,9000,4595,4405,8724,71,0,43,111,45244,1793,4037.0,4242.0
1588,"Fulton County, Kentucky",3077,200,147,142,193,205,160,50,21,75,21075,475,492,862,514,407,451,871,716,882,943,1733,1230,6130,3077,3053,4410,1472,9,35,120,30114,975,2382.0,2421.0
1589,"Knott County, Kentucky",7504,402,391,308,415,418,406,240,21,119,21119,1246,1251,2215,1205,1249,1274,2266,1488,2495,2525,4481,2693,15260,7504,7756,14846,79,32,65,149,31198,2826,5763.0,6251.0
1590,"Menifee County, Kentucky",3414,255,143,150,108,164,182,105,21,165,21165,464,538,991,632,354,551,895,670,818,1089,1886,1302,6443,3414,3029,6331,10,20,0,73,39325,1430,2779.0,3102.0
1591,"Muhlenberg County, Kentucky",15239,827,765,600,824,561,1163,590,21,177,21177,2581,2816,4176,2498,2203,2822,4284,3265,4784,5638,8460,5763,30951,15239,15712,28689,1404,243,68,472,43590,6570,13060.0,14229.0
1592,"Perry County, Kentucky",13179,878,660,501,802,638,890,456,21,193,21193,1785,2494,3711,2033,1790,2483,4070,2316,3575,4977,7781,4349,26624,13179,13445,25529,495,229,34,278,33640,5275,10572.0,10606.0
1593,"Wolfe County, Kentucky",3603,271,135,191,184,264,170,108,21,237,21237,456,605,969,631,424,667,1042,745,880,1272,2011,1376,7207,3603,3604,7097,4,5,3,26,24623,1222,2635.0,2981.0
1594,"Clay County, Kentucky",10674,597,599,382,619,656,512,335,21,51,21051,1681,2561,2891,1323,1338,1790,2762,1682,3019,4351,5653,3005,20368,10674,9694,19055,799,0,144,522,26840,3276,6767.0,6498.0
1595,"Bell County, Kentucky",13174,830,719,512,773,855,674,438,21,13,21013,2034,2342,3672,2167,1893,2339,3833,2812,3927,4681,7505,4979,26791,13174,13617,25531,742,45,36,285,26272,4558,9718.0,10044.0
1596,"Cumberland County, Kentucky",3253,200,208,82,222,245,132,153,21,57,21057,385,483,991,669,406,523,992,771,791,1006,1983,1440,6697,3253,3444,6216,140,51,148,91,35344,1521,3066.0,3309.0
1597,"Graves County, Kentucky",18338,1069,1303,884,1149,1123,1215,789,21,83,21083,2709,3163,4757,2999,2702,3188,4954,3790,5411,6351,9711,6789,37248,18338,18910,33366,1662,169,913,2491,44043,7102,16606.0,17018.0
1598,"Lee County, Kentucky",3624,210,192,201,159,173,209,66,21,129,21129,534,677,1075,539,407,564,1022,657,941,1241,2097,1196,6881,3624,3257,6612,52,15,0,30,25275,1392,2667.0,2659.0
1599,"Butler County, Kentucky",6420,388,425,309,356,377,397,221,21,31,21031,865,1224,1726,1065,814,1183,1755,1241,1679,2407,3481,2306,12764,6420,6344,12366,81,40,109,419,41763,2709,5576.0,6125.0
1600,"Edmonson County, Kentucky",6117,256,250,237,297,251,356,216,21,61,21061,990,1108,1729,1150,778,1083,1743,1297,1768,2191,3472,2447,12138,6117,6021,11588,181,10,2,91,43401,2426,5244.0,6131.0
1601,"Harrison County, Kentucky",9241,648,388,452,491,736,460,425,21,97,21097,1302,1533,2724,1482,1219,1635,2731,1784,2521,3168,5455,3266,18722,9241,9481,17824,322,0,79,452,48438,3806,7781.0,8853.0
1602,"Bracken County, Kentucky",4184,275,270,182,255,289,251,161,21,23,21023,549,781,1209,612,563,708,1165,729,1112,1489,2374,1341,8305,4184,4121,8047,30,91,0,68,49158,1970,3527.0,4244.0
1603,"Nelson County, Kentucky",22785,1536,1614,1023,1332,1448,1344,952,21,179,21179,3419,4093,6205,3251,3330,4202,6533,3724,6749,8295,12738,6975,45650,22785,22865,41726,2341,247,409,985,60127,9079,20802.0,23256.0
1604,"Wayne County, Kentucky",10227,615,496,397,581,587,616,347,21,231,21231,1345,2053,2721,1924,1366,1682,2940,2200,2711,3735,5661,4124,20546,10227,10319,19378,407,32,448,685,34914,3868,7992.0,9240.0
1605,"Marion County, Kentucky",9759,576,689,448,572,601,666,358,21,155,21155,1524,1732,2693,1322,1322,1543,2571,1852,2846,3275,5264,3174,19244,9759,9485,17349,1408,41,53,515,40107,4005,8111.0,8928.0
1606,"Trigg County, Kentucky",7196,518,540,327,353,349,486,276,21,221,21221,887,1026,1934,1627,793,1203,2212,1581,1680,2229,4146,3208,14449,7196,7253,13062,1076,68,50,325,50536,2753,6751.0,7375.0
1607,"Boone County, Kentucky",64953,4456,4571,3121,4233,4759,5014,2904,21,15,21015,9398,13268,17076,7534,8977,13269,17381,9330,18375,26537,34457,16864,130820,64953,65867,118715,3815,3137,1841,5546,78327,25887,57618.0,66953.0
1608,"Jessamine County, Kentucky",25630,1736,1842,1058,1689,1828,1762,1134,21,113,21113,4105,4795,6662,3548,4429,5133,7188,4239,8534,9928,13850,7787,53032,25630,27402,48430,2445,766,346,1837,58245,11200,23326.0,26251.0
1609,"Knox County, Kentucky",15302,1019,1013,673,990,973,985,626,21,121,21121,2697,2655,3887,2308,2391,2824,4215,3059,5088,5479,8102,5367,31365,15302,16063,30238,255,118,24,379,30181,5536,12012.0,13279.0
1610,"Letcher County, Kentucky",10850,649,466,408,641,477,834,388,21,133,21133,1455,1981,3071,1864,1373,2110,3358,2264,2828,4091,6429,4128,22295,10850,11445,21812,83,59,39,179,29886,4133,9134.0,9148.0
1611,"Livingston County, Kentucky",4581,276,272,182,241,217,284,161,21,139,21139,534,751,1367,906,551,758,1406,1036,1085,1509,2773,1942,9235,4581,4654,8980,42,13,3,183,50839,2033,4645.0,5003.0
1612,"Pike County, Kentucky",28874,1641,1648,1203,1623,1599,1731,1063,21,195,21195,4364,5297,8275,4640,4101,5478,8907,6121,8465,10775,17182,10761,59497,28874,30623,58027,530,331,56,571,34856,11354,24665.0,25368.0
1613,"Shelby County, Kentucky",22962,1594,1619,1012,1537,1255,1579,926,21,211,21211,3249,4469,6238,3256,3642,4652,6786,3986,6891,9121,13024,7242,47325,22962,24363,41165,3244,439,1148,4541,67056,9415,20580.0,23542.0
1614,"Anderson County, Kentucky",10976,758,829,535,676,748,688,431,21,5,21005,1509,2025,3162,1475,1516,2084,3306,1984,3025,4109,6468,3459,22409,10976,11433,21341,627,61,42,403,55334,4343,11422.0,13261.0
1615,"Breckinridge County, Kentucky",10173,593,479,458,563,497,725,399,21,27,21027,1347,1684,2863,1838,1223,1650,2896,2050,2570,3334,5759,3888,20176,10173,10003,19266,358,71,76,314,47190,4167,8774.0,10194.0
1616,"Franklin County, Kentucky",24519,1510,1380,861,1388,1332,1517,909,21,73,21073,4023,4575,6805,3692,4014,4658,7279,4913,8037,9233,14084,8605,50529,24519,26010,41652,4729,915,1197,1702,56274,10896,23865.0,26059.0
1617,"McCreary County, Kentucky",9525,547,686,349,538,331,676,334,21,147,21147,1539,2140,2500,1270,1105,1380,2174,1402,2644,3520,4674,2672,17465,9525,7940,15732,989,79,90,432,28105,2764,5776.0,6435.0
1618,"Madison County, Kentucky",44220,2595,2994,1609,2551,2470,2686,1533,21,151,21151,10773,8099,10292,5341,11460,8135,10957,6790,22233,16234,21249,12131,90802,44220,46582,82952,3728,808,513,2247,50060,17047,37371.0,43903.0
1619,"Metcalfe County, Kentucky",4999,316,308,225,325,196,410,158,21,169,21169,676,788,1520,798,607,827,1428,1086,1283,1615,2948,1884,10036,4999,5037,9608,156,40,0,82,37386,1894,4620.0,5014.0
1620,"Owsley County, Kentucky",2018,114,117,69,241,75,110,70,21,189,21189,363,353,555,345,301,391,737,499,664,744,1292,844,4442,2018,2424,4150,243,7,42,0,30284,852,1759.0,1895.0
1621,"Simpson County, Kentucky",8952,639,683,399,533,716,512,365,21,213,21213,1385,1624,2344,1278,1294,1571,2532,1708,2679,3195,4876,2986,18183,8952,9231,15583,1867,121,134,444,48623,3250,7531.0,8732.0
1622,"Clark County, Kentucky",17561,1255,1097,689,984,910,1148,720,21,49,21049,2376,3131,4927,2823,2586,3330,5247,3485,4962,6461,10174,6308,35971,17561,18410,33297,1674,221,149,1045,54953,6775,16205.0,26584.0
1623,"Todd County, Kentucky",6087,426,477,272,423,410,572,273,21,219,21219,869,1122,1608,877,804,1127,1576,1044,1673,2249,3184,1921,12316,6087,6229,10771,1012,8,323,491,44005,2215,4779.0,5351.0
1624,"Carroll County, Kentucky",5466,393,491,180,399,361,407,193,21,41,21041,780,1135,1428,732,762,909,1296,878,1542,2044,2724,1610,10671,5466,5205,9793,340,35,349,723,43524,1823,3855.0,4135.0
1625,"Clinton County, Kentucky",5093,316,248,231,349,302,283,191,21,53,21053,695,893,1405,896,655,854,1417,1049,1350,1747,2822,1945,10193,5093,5100,9890,37,30,85,289,32184,1883,4462.0,4932.0
1626,"Gallatin County, Kentucky",4491,325,252,244,245,303,245,160,21,77,21077,695,770,1245,580,632,784,1264,613,1327,1554,2509,1193,8737,4491,4246,8121,176,6,274,460,52167,1787,3338.0,3849.0
1627,"Richland Parish, Louisiana",9909,677,615,475,575,762,535,425,22,83,22083,1645,1754,2449,1548,1486,1916,2796,1946,3131,3670,5245,3494,20350,9909,10441,12604,7339,78,62,451,34029,2957,9597.0,9940.0
1628,"Mahnomen County, Minnesota",2788,247,307,130,235,238,220,120,27,87,27087,348,406,657,451,357,410,620,513,705,816,1277,964,5501,2788,2713,2572,29,19,12,239,44688,703,2088.0,2302.0
1629,"Chisago County, Minnesota",28780,1570,1671,1228,1531,1428,1907,1137,27,25,27025,3997,5589,8543,3960,3349,4996,7882,4305,7346,10585,16425,8265,55315,28780,26535,52713,729,624,79,1205,83464,11506,30228.0,34513.0
1630,"Redwood County, Minnesota",7706,484,433,347,443,591,488,287,27,127,27127,986,1239,2134,1449,897,1153,1927,1769,1883,2392,4061,3218,15261,7706,7555,13428,119,409,277,534,55404,2992,7611.0,8290.0
1631,"Yellow Medicine County, Minnesota",4984,292,285,214,319,345,256,180,27,173,27173,628,917,1374,904,590,768,1298,1074,1218,1685,2672,1978,9814,4984,4830,9090,68,60,146,461,59210,1942,5276.0,5525.0
1632,"Todd County, Minnesota",12591,840,907,548,815,679,839,416,27,153,27153,1531,1937,3524,2519,1394,1838,3320,2602,2925,3775,6844,5121,24494,12591,11903,23109,173,157,543,1478,53585,4750,11993.0,13238.0
1633,"Beltrami County, Minnesota",23137,1622,1780,900,1615,1786,1406,840,27,7,27007,4689,3943,5096,3370,4491,3888,5394,3846,9180,7831,10490,7216,46403,23137,23266,33818,729,348,3,1130,49160,7652,21564.0,24121.0
1634,"Blue Earth County, Minnesota",33456,1849,1866,1065,1815,1965,1589,1066,27,13,27013,9918,5975,6790,3998,9489,5344,7138,4933,19407,11319,13928,8931,66795,33456,33339,60604,2578,1443,341,2438,57429,13150,33593.0,36027.0
1635,"Houston County, Minnesota",9368,514,636,342,508,527,561,342,27,55,27055,1134,1550,2771,1812,1005,1531,2747,2059,2139,3081,5518,3871,18648,9368,9280,18069,243,72,42,211,60382,4370,10604.0,11435.0
1636,"Lac qui Parle County, Minnesota",3368,162,217,118,148,173,197,120,27,73,27073,348,507,1018,829,334,472,945,962,682,979,1963,1791,6719,3368,3351,6452,58,57,76,152,53071,1443,3860.0,4039.0
1637,"Lake of the Woods County, Minnesota",2009,176,109,40,34,51,146,127,27,77,27077,183,297,637,451,170,243,556,435,353,540,1193,886,3771,2009,1762,3508,2,3,1,3,49967,879,2242.0,2405.0
1638,"Otter Tail County, Minnesota",29326,1741,1942,1102,1662,1746,1668,1040,27,111,27111,3547,4489,8330,6441,3142,4306,8167,7138,6689,8795,16497,13579,58195,29326,28869,55244,870,348,566,2017,58682,11685,32500.0,36372.0
1639,"Waseca County, Minnesota",9005,522,641,404,558,554,695,415,27,161,27161,1286,1658,2398,1510,1319,1992,2453,1749,2605,3650,4851,3259,18740,9005,9735,17409,444,113,314,1124,56762,3931,9653.0,10386.0
1640,"St. Louis County, Minnesota",100118,5169,5067,3344,5002,4826,5599,3154,27,137,27137,18987,17484,26738,17368,17961,16070,26770,20259,36948,33554,53508,37627,199759,100118,99641,183938,3154,2060,907,3394,55646,39710,112422.0,119859.0
1641,"Anoka County, Minnesota",175259,11178,11430,7567,10700,11131,12147,7167,27,3,27003,25555,35929,49353,21533,23893,34830,49254,25872,49448,70759,98607,47405,350253,175259,174994,292866,21877,15645,5688,15996,82175,73814,185758.0,210975.0
1642,"Stearns County, Minnesota",79704,5155,5118,3168,5040,4971,5029,3066,27,145,27145,17434,14102,18951,10665,16383,13118,18718,12423,33817,27220,37669,23088,158452,79704,78748,139188,10217,3304,2119,5342,62789,29475,79592.0,84647.0
1643,"Dakota County, Minnesota",207870,14186,14436,9096,13143,13830,14596,8671,27,37,27037,30369,42428,56440,25407,29138,42842,59345,32018,59507,85270,115785,57425,421453,207870,213583,345909,26362,20348,11845,30100,86036,93231,231440.0,260665.0
1644,"Lyon County, Minnesota",12830,975,957,512,891,838,883,541,27,83,27083,2206,2366,3095,1760,2140,2261,3148,2226,4346,4627,6243,3986,25758,12830,12928,22201,891,1117,996,1770,57730,4939,12215.0,12877.0
1645,"Marshall County, Minnesota",4735,280,317,170,281,285,345,188,27,89,27089,641,755,1371,930,531,728,1237,1042,1172,1483,2608,1972,9372,4735,4637,9073,33,33,65,424,60118,1970,4817.0,5093.0
1646,"Renville County, Minnesota",7456,473,504,269,417,422,522,279,27,129,27129,984,1196,2131,1411,803,1183,1979,1591,1787,2379,4110,3002,14652,7456,7196,13095,56,100,981,1253,59028,2685,7606.0,8115.0
1647,"Washington County, Minnesota",126626,7769,9291,5842,7560,8536,9272,5627,27,163,27163,17697,24602,35387,16867,16400,24827,37047,20043,34097,49429,72434,36910,255938,126626,129312,218513,11757,14773,2077,10716,96671,60157,144235.0,166222.0
1648,"Cook County, Minnesota",2661,107,109,63,130,79,126,80,27,31,27031,292,419,809,733,305,398,864,733,597,817,1673,1466,5376,2661,2715,4634,4,50,78,124,57432,1357,3395.0,3786.0
1649,"Knox County, Missouri",1977,134,136,110,111,109,127,97,29,103,29103,275,281,545,377,242,279,535,470,517,560,1080,847,3947,1977,1970,3804,18,24,23,43,40000,934,1870.0,1856.0
1650,"Montgomery County, Missouri",5724,376,321,243,331,380,288,194,29,139,29139,707,953,1639,1055,658,947,1672,1293,1365,1900,3311,2348,11487,5724,5763,10893,171,29,123,225,46757,2632,5429.0,5770.0
1651,"Stoddard County, Missouri",14277,912,921,637,782,864,1032,568,29,207,29207,2056,2579,3806,2516,1974,2621,3999,3260,4030,5200,7805,5776,29377,14277,15100,28474,437,3,32,514,41062,6080,13291.0,13410.0
1652,"Audrain County, Missouri",11825,865,750,692,732,647,856,468,29,7,29007,1571,2023,3119,1888,2215,2701,3646,2554,3786,4724,6765,4442,25644,11825,13819,22789,1464,33,163,797,44261,4869,10061.0,10660.0
1653,"Greene County, Missouri",140944,8833,8466,4939,8583,8084,8169,4705,29,77,29077,30314,26994,32953,19719,31275,26059,34993,26944,61589,53053,67946,46663,289756,140944,148812,260411,9558,5930,3176,10786,46086,56910,129231.0,138074.0
1654,"St. Clair County, Missouri",4655,247,248,169,233,128,415,161,29,185,29185,553,671,1334,1206,450,618,1370,1340,1003,1289,2704,2546,9370,4655,4715,8955,68,36,10,120,38870,2042,4630.0,4972.0
1655,"Schuyler County, Missouri",2237,191,122,114,163,232,110,94,29,197,29197,323,332,581,403,328,346,571,474,651,678,1152,877,4555,2237,2318,4419,21,12,4,76,42694,978,1936.0,2005.0
1656,"Camden County, Missouri",22422,1026,1032,1016,921,992,1351,722,29,29,29029,2493,2987,6463,6256,2371,3123,7238,6326,4864,6110,13701,12582,45466,22422,23044,43778,364,139,276,1242,53478,10332,22514.0,24774.0
1657,"Jefferson County, Missouri",111162,6643,7344,4638,6612,7717,6963,4365,29,99,29099,15852,22241,31534,14780,15169,21951,32302,17710,31021,44192,63836,32490,223951,111162,112789,215137,2119,1817,251,4398,65454,42390,106238.0,116629.0
1658,"New Madrid County, Missouri",8388,559,650,286,547,552,661,291,29,143,29143,1204,1417,2299,1416,1189,1572,2521,1839,2393,2989,4820,3255,17560,8388,9172,14313,2703,0,16,330,38679,3225,7357.0,7248.0
1659,"Ralls County, Missouri",5196,266,329,202,258,267,348,180,29,173,29173,668,840,1525,1034,571,851,1456,1107,1239,1691,2981,2141,10234,5196,5038,9860,135,59,28,128,55377,2668,5266.0,5662.0
1660,"Custer County, Montana",5850,348,366,249,320,346,292,240,30,17,30017,846,1025,1598,1004,845,977,1620,1239,1691,2002,3218,2243,11729,5850,5879,10990,74,11,86,401,52965,2356,5185.0,5878.0
1661,"Powder River County, Montana",811,57,13,30,49,3,36,29,30,75,30075,128,87,235,217,99,86,271,223,227,173,506,440,1607,811,796,1515,0,0,2,51,54427,342,1053.0,1136.0
1662,"Roosevelt County, Montana",5502,500,487,302,520,531,597,257,30,85,30085,930,991,1185,555,858,973,1252,685,1788,1964,2437,1240,11175,5502,5673,4029,24,67,20,442,43194,1251,3652.0,4015.0
1663,"Liberty County, Montana",1115,71,75,33,44,87,41,78,30,51,30051,67,170,307,288,126,240,318,302,193,410,625,590,2351,1115,1236,2340,0,0,0,29,44875,351,961.0,1083.0
1664,"Richland County, Montana",5709,356,297,275,330,423,450,223,30,83,30083,864,1178,1459,801,791,963,1463,847,1655,2141,2922,1648,11199,5709,5490,10445,0,3,103,608,67205,2303,4871.0,5789.0
1665,"Toole County, Montana",2720,125,133,76,136,159,48,148,30,101,30101,420,628,835,397,228,323,702,428,648,951,1537,825,4892,2720,2172,4376,23,32,12,196,50721,1020,2037.0,2123.0
1666,"Daniels County, Montana",925,34,48,89,53,33,59,0,30,19,30019,77,144,282,173,41,149,220,250,118,293,502,423,1730,925,805,1655,0,14,0,46,57440,411,962.0,1014.0
1667,"Judith Basin County, Montana",1064,28,46,70,66,22,40,47,30,45,30045,96,149,368,227,56,146,297,216,152,295,665,443,1954,1064,890,1856,0,0,0,70,43661,454,1208.0,1344.0
1668,"Deer Lodge County, Montana",4796,178,170,280,165,173,240,86,30,23,30023,723,811,1445,1031,471,762,1369,1044,1194,1573,2814,2075,9106,4796,4310,8459,68,69,42,315,41820,1995,4206.0,4888.0
1669,"McCone County, Montana",902,55,66,43,62,107,47,4,30,55,30055,111,149,236,205,107,100,217,244,218,249,453,449,1790,902,888,1653,0,29,0,67,49701,393,1060.0,1128.0
1670,"Rosebud County, Montana",4567,360,370,166,307,241,451,313,30,87,30087,652,702,1246,664,621,744,1218,690,1273,1446,2464,1354,9152,4567,4585,5218,16,95,187,473,57992,1266,3453.0,3782.0
1671,"Dawson County, Montana",4759,298,272,163,277,300,178,160,30,21,30021,784,946,1250,782,599,692,1160,892,1383,1638,2410,1674,9017,4759,4258,8522,70,22,47,281,58596,1658,4374.0,4837.0
1672,"Broadwater County, Montana",3035,147,111,115,125,150,171,125,30,7,30007,350,463,907,729,318,443,915,663,668,906,1822,1392,5945,3035,2910,5736,5,0,19,166,60594,1461,3133.0,4056.0
1673,"Phillips County, Montana",2089,153,151,113,126,141,101,33,30,71,30071,255,307,537,439,202,261,652,472,457,568,1189,911,4077,2089,1988,3442,0,12,20,114,46212,786,2171.0,2384.0
1674,"Blaine County, Nebraska",243,14,9,5,13,18,19,4,31,9,31009,21,38,79,55,10,28,65,77,31,66,144,132,477,243,234,477,0,0,0,0,51094,124,317.0,317.0
1675,"Deuel County, Nebraska",875,49,38,29,56,54,62,14,31,49,31049,89,143,291,179,124,132,263,251,213,275,554,430,1831,875,956,1747,3,11,3,156,47287,339,984.0,1082.0
1676,"Logan County, Nebraska",503,44,30,28,18,16,26,32,31,113,31113,40,97,116,86,32,90,110,100,72,187,226,186,927,503,424,915,0,0,0,44,52708,179,453.0,450.0
1677,"Thayer County, Nebraska",2542,163,145,90,143,201,124,94,31,169,31169,294,386,684,587,247,339,671,696,541,725,1355,1283,5057,2542,2515,4890,25,0,32,131,51821,1054,2690.0,2951.0
1678,"Adams County, Nebraska",15846,1065,1180,655,944,994,1077,585,31,1,31001,2787,2695,3967,2486,2558,2566,3907,3110,5345,5261,7874,5596,31587,15846,15741,29380,203,405,849,3254,53023,5693,13513.0,14650.0
1679,"Boone County, Nebraska",2611,163,168,97,166,206,151,98,31,11,31011,345,404,738,517,298,372,721,656,643,776,1459,1173,5279,2611,2668,5195,17,29,2,115,54979,1153,2905.0,3217.0
1680,"St. Martin Parish, Louisiana",26437,1835,1848,1127,1858,1810,1750,1043,22,99,22099,4500,4884,6820,3631,4146,5002,7406,4280,8646,9886,14226,7911,53732,26437,27295,35874,15629,536,256,1611,48656,9251,25750.0,27038.0
1681,"Vernon Parish, Louisiana",26265,2024,1723,907,2112,1894,1322,827,22,115,22115,7282,5314,4798,2574,4683,4623,4671,3249,11965,9937,9469,5823,49646,26265,23381,37633,7294,1045,1198,4617,49141,8807,16633.0,17268.0
1682,"Winn Parish, Louisiana",7625,359,296,251,412,401,418,286,22,127,22127,1267,1804,1976,1153,861,1116,1731,1463,2128,2920,3707,2616,14313,7625,6688,9471,4533,0,116,293,38353,2697,6372.0,6223.0
1683,"East Baton Rouge Parish, Louisiana",212317,14720,14086,8530,14527,13673,13627,8088,22,33,22033,47310,40455,47397,25805,48874,42801,54759,35097,96184,83256,102156,60902,443763,212317,231446,207835,204562,14125,8001,18565,54948,80094,196491.0,208111.0
1684,"Sabine Parish, Louisiana",11853,738,811,534,721,862,717,467,22,85,22085,1651,1913,3092,2273,1577,2109,3133,2552,3228,4022,6225,4825,23991,11853,12138,16626,3834,86,146,931,40336,4175,9787.0,10596.0
1685,"Allen Parish, Louisiana",14542,816,795,572,809,752,766,381,22,3,22003,2342,3683,3863,1626,1462,1931,2826,2149,3804,5614,6689,3775,25618,14542,11076,18941,4845,152,440,1592,46446,4640,9245.0,9810.0
1686,"Madison Parish, Louisiana",5630,415,268,218,406,473,272,199,22,65,22065,1139,1219,1206,709,881,1154,1433,858,2020,2373,2639,1567,11306,5630,5676,3995,7202,0,58,239,30350,1111,4732.0,4670.0
1687,"Jefferson Davis Parish, Louisiana",15550,1168,1101,788,1058,928,1157,601,22,53,22053,2403,2748,3894,2259,2263,2908,4170,2806,4666,5656,8064,5065,31441,15550,15891,25176,5178,154,88,772,42105,5690,14277.0,14841.0
1688,"St. James Parish, Louisiana",10111,639,729,333,629,588,731,576,22,93,22093,1642,1771,2818,1514,1594,2003,3032,2044,3236,3774,5850,3558,21308,10111,11197,10366,10565,35,182,355,51603,3530,12085.0,12589.0
1689,"Grant Parish, Louisiana",12624,618,664,412,642,684,551,376,22,43,22043,2241,3368,3098,1549,1331,1826,2573,1733,3572,5194,5671,3282,22340,12624,9716,17554,3618,26,547,1125,42505,3755,8821.0,9392.0
1690,"West Feliciana Parish, Louisiana",9875,226,436,310,409,233,319,155,22,125,22125,1415,2802,3165,1093,921,958,1481,1077,2336,3760,4646,2170,15428,9875,5553,8250,6861,94,19,191,59637,2918,5799.0,6268.0
1691,"Jefferson Parish, Louisiana",210690,14553,13282,7772,13669,13090,12710,7524,22,51,22051,32517,42312,55738,31216,32857,43139,60054,41117,65374,85451,115792,72333,434850,210690,224160,271300,117314,18260,16478,63104,54032,81623,181639.0,193631.0
1692,"Monroe County, Alabama",10160,652,753,464,483,611,653,443,1,99,01099,1491,1542,2785,1784,1554,1893,3157,2316,3045,3435,5942,4100,21270,10160,11110,11587,9026,58,22,81,30441,3263,10271.0,10620.0
1693,"Lawrence County, Alabama",15955,829,1073,592,950,860,1227,606,1,79,01079,2225,2886,4677,2627,2360,2860,4869,3371,4585,5746,9546,5998,33058,15955,17103,25799,3502,65,98,724,44886,6084,14829.0,15957.0
1694,"Lee County, Alabama",79453,4881,4886,2973,4646,4563,4766,2693,1,81,01081,21605,14489,17220,8419,20597,15538,18619,10277,42202,30027,35839,18696,161152,79453,81699,113359,36920,6899,643,5925,51463,27835,59191.0,70980.0
1695,"Marion County, Alabama",14781,774,881,633,778,742,892,548,1,93,01093,2119,2359,4251,2738,1966,2514,4095,3550,4085,4873,8346,6288,29866,14781,15085,27739,1070,54,355,777,35930,4917,12984.0,13786.0
1696,"Pickens County, Alabama",9637,577,540,389,480,511,553,363,1,107,01107,1524,1687,2625,1677,1537,2045,3055,2062,3061,3732,5680,3739,20243,9637,10606,11477,8134,12,278,985,39848,3077,9542.0,9659.0
1697,"Sumter County, Alabama",5927,378,383,290,337,369,297,146,1,119,01119,1510,745,1449,902,1749,899,1741,1332,3259,1644,3190,2234,12797,5927,6870,3229,9204,274,50,68,24320,1612,6411.0,6282.0
1698,"Jefferson County, Alabama",312033,21618,21375,12520,20902,20596,20493,12357,1,73,01073,52724,61540,78835,42105,55451,68117,90051,59680,108175,129657,168886,101785,659680,312033,347647,341768,283311,10433,11610,25557,53901,124801,304191.0,324675.0
1699,"Choctaw County, Alabama",6145,318,324,294,361,304,370,203,1,23,01023,805,955,1745,1275,849,1079,1967,1647,1654,2034,3712,2922,12925,6145,6780,7337,5500,17,12,53,35892,1786,7292.0,7461.0
1700,"Franklin County, Alabama",15676,1100,836,675,1119,1085,983,682,1,59,01059,2493,3078,3745,2345,2210,2739,4013,2959,4703,5817,7758,5304,31466,15676,15790,26118,1385,117,3030,5400,43514,5117,12040.0,12564.0
1701,"Marengo County, Alabama",9299,566,895,402,403,536,691,379,1,91,01091,1403,1491,2396,1615,1408,1721,2770,2114,2811,3212,5166,3729,19321,9299,10022,8840,10348,0,28,196,33241,2577,10994.0,10882.0
1702,"Russell County, Alabama",27861,2072,2201,1095,2086,2160,1701,1098,1,113,01113,4699,5594,7127,3317,4776,5857,7701,4712,9475,11451,14828,8029,57952,27861,30091,28519,25300,553,1290,3182,42443,8278,19256.0,21108.0
1703,"Cherokee County, Alabama",12777,656,688,520,531,766,739,595,1,19,01019,1719,1951,3793,2700,1465,2015,3904,3111,3184,3966,7697,5811,25903,12777,13126,24052,1191,64,91,413,41919,5188,10733.0,12275.0
1704,"Covington County, Alabama",17986,1105,1383,692,1060,1043,1109,739,1,39,01039,2494,2954,4976,3350,2475,3206,5206,4376,4969,6160,10182,7726,37200,17986,19214,31460,5018,184,66,629,42189,6546,15940.0,17418.0
1705,"Crenshaw County, Alabama",6748,413,380,308,375,472,394,243,1,41,01041,979,1152,1867,1128,956,1208,1967,1481,1935,2360,3834,2609,13844,6748,7096,9879,3228,175,22,110,43163,2613,6267.0,6617.0
1706,"Dallas County, Alabama",18039,1202,1477,869,1191,1421,1221,847,1,47,01047,2731,2925,4769,2865,3160,3658,5668,3944,5891,6583,10437,6809,39149,18039,21110,10906,27693,222,27,419,33845,4601,18792.0,17861.0
1707,"Lauderdale County, Alabama",44568,2523,2701,1645,2262,2312,2568,1657,1,77,01077,8134,7578,11461,7885,8360,7821,12665,10343,16494,15399,24126,18228,92556,44568,47988,80436,9596,593,225,2476,48094,18437,39525.0,44149.0
1708,"Lowndes County, Alabama",4821,363,261,270,250,326,349,148,1,85,01085,688,815,1330,790,763,849,1507,1066,1451,1664,2837,1856,10079,4821,5258,2497,7522,0,0,50,30036,1088,6684.0,6830.0
1709,"Macon County, Alabama",8593,422,546,323,412,435,457,267,1,87,01087,2080,1191,2132,1513,2492,1376,2575,2101,4572,2567,4707,3614,18708,8593,10115,3000,15560,32,11,152,33370,2600,9140.0,8697.0
1710,"Limestone County, Alabama",47291,2593,3186,2060,2624,2484,3612,2059,1,83,01083,7016,9979,13078,6414,6386,9250,13107,7914,13402,19229,26185,14328,94727,47291,47436,76003,13028,1309,1859,5700,59686,17738,40294.0,48754.0
1711,"Shelby County, Alabama",103346,6165,6811,4744,6276,7076,7092,4547,1,117,01117,14846,21036,27705,14125,15338,22176,29990,17591,30184,43212,57695,31716,213432,103346,110086,170998,25878,4399,7096,12208,77799,46207,101254.0,114439.0
1712,"Winston County, Alabama",11781,712,606,438,603,492,845,463,1,133,01133,1484,1994,3474,2306,1521,1917,3393,2769,3005,3911,6867,5075,23784,11781,12003,22845,174,37,190,750,35788,4565,10313.0,11273.0
1713,"Baldwin County, Alabama",103496,5948,5583,4304,5741,6475,6549,3922,1,3,01003,13832,18371,28010,19735,13825,19231,30795,22796,27657,37602,58805,42531,212830,103496,109334,183471,19718,1969,2429,9711,58320,43941,95215.0,108945.0
1714,"Elmore County, Alabama",39226,2386,2567,1643,2351,2362,2649,1636,1,51,01051,6342,7870,10337,5446,6392,8557,11364,6607,12734,16427,21701,12053,81144,39226,41918,61104,17449,439,589,2404,60891,15159,37260.0,40891.0
1715,"Jackson County, Alabama",25381,1529,1673,1000,1227,1480,1525,1027,1,71,01071,3477,4488,7241,4452,3423,4669,7459,5661,6900,9157,14700,10113,51852,25381,26471,47456,1809,232,262,1519,41769,9743,20984.0,23602.0
1716,"Talladega County, Alabama",38826,2233,2388,1645,2033,2555,2406,1574,1,121,01121,6034,7040,10779,6284,6330,7465,11430,7768,12364,14505,22209,14052,80387,38826,41561,51398,26215,494,510,1842,41325,11744,33407.0,35591.0
1717,"Washington County, Alabama",8159,392,423,454,409,422,548,531,1,129,01129,1202,1237,2455,1387,1007,1312,2493,1660,2209,2549,4948,3047,16541,8159,8382,10972,3894,42,15,241,41370,2740,8533.0,8861.0
1718,"Clay County, Alabama",6438,328,375,247,352,302,500,204,1,27,01027,890,1111,1809,1208,975,1171,1905,1490,1865,2282,3714,2698,13337,6438,6899,11092,2075,21,18,419,40845,2195,6624.0,6913.0
1719,"Morgan County, Alabama",58712,3705,4310,2495,3476,3838,3554,2435,1,103,01103,8650,11079,16073,8846,8274,10770,16588,11566,16924,21849,32661,20412,119213,58712,60501,95265,15230,760,4612,9962,52156,20035,50644.0,53482.0
1720,"Pike County, Alabama",15980,956,1056,506,870,930,803,515,1,109,01109,4829,2281,3305,2213,5093,2561,3848,2733,9922,4842,7153,4946,33333,15980,17353,19301,12277,734,23,750,37446,5026,13168.0,13796.0
1721,"Colbert County, Alabama",26284,1701,1477,1042,1438,1817,1374,993,1,33,01033,3951,4687,7169,4546,3903,4908,7956,6098,7854,9595,15125,10644,54771,26284,28487,43289,8872,259,866,1557,48065,10429,24915.0,24668.0
1722,"Dale County, Alabama",24301,1620,1827,988,1611,1486,1545,909,1,45,01045,4328,4544,6005,3590,3747,4742,6445,4491,8075,9286,12450,8081,49277,24301,24976,35655,10000,699,913,3210,47214,7524,18749.0,19699.0
1723,"Hale County, Alabama",7035,529,558,328,455,341,566,281,1,65,01065,1073,1109,1823,1219,1133,1322,2118,1558,2206,2431,3941,2777,14809,7035,7774,5854,8796,33,32,4,34046,1909,8040.0,7922.0
1724,"DeKalb County, Alabama",35318,2242,2342,1660,2018,2390,2530,1524,1,49,01049,5247,6391,9374,5258,4988,6584,9333,6625,10235,12975,18707,11883,71310,35318,35992,60924,1039,86,6136,10376,40440,11931,25826.0,29322.0
1725,"Escambia County, Alabama",18856,1083,1203,692,1020,980,1401,733,1,53,01053,2941,3955,4975,2831,2532,3183,4617,3735,5473,7138,9592,6566,37057,18856,18201,23053,11878,102,108,865,36275,5707,14845.0,15861.0
1726,"Randolph County, Alabama",11057,683,721,518,634,653,663,355,1,111,01111,1564,1757,3068,2077,1628,1872,3240,2545,3192,3629,6308,4622,22647,11057,11590,17452,4622,47,83,668,43395,3765,10187.0,10824.0
1727,"Mobile County, Alabama",197367,13566,12819,8549,13636,13291,13225,8192,1,97,01097,33324,36303,50207,28066,34625,40299,56206,37273,67949,76602,106413,65339,414114,197367,216747,242715,148050,7928,4542,12018,47583,70654,172737.0,181783.0
1728,"Perry County, Alabama",4263,174,121,253,310,60,551,142,1,105,01105,965,775,863,716,900,973,1038,1056,1865,1748,1901,1772,9293,4263,5030,2737,6491,8,54,110,23447,1469,5278.0,5215.0
1729,"Cleburne County, Alabama",7309,438,540,319,411,576,420,265,1,29,01029,1017,1298,1970,1313,946,1277,2126,1586,1963,2575,4096,2899,14916,7309,7607,14000,410,3,198,367,44741,2936,6593.0,7210.0
1730,"Conecuh County, Alabama",6078,383,532,179,317,264,308,281,1,35,01035,864,895,1634,1251,820,1034,1797,1495,1684,1929,3431,2746,12394,6078,6316,6287,5919,56,2,84,37837,1933,6585.0,6419.0
1731,"Barbour County, Alabama",13421,696,725,470,653,897,652,444,1,5,01005,2341,2927,3465,2027,1576,1926,3109,2683,3917,4853,6574,4710,25361,13421,11940,11869,12066,134,905,1105,32525,2913,10469.0,10457.0
1732,"Bibb County, Alabama",12150,701,674,600,614,545,504,365,1,7,01007,1736,2873,3342,1596,1546,1725,3056,1988,3282,4598,6398,3584,22493,12150,10343,17272,5014,27,9,579,47542,3913,8819.0,9573.0
1733,"Calhoun County, Alabama",55141,3254,3456,2468,3354,3163,3527,2108,1,15,01015,9315,9976,14678,8372,9309,10781,15869,11366,18624,20757,30547,19738,114618,55141,59477,84439,23830,1014,2202,4352,47255,18280,47864.0,50743.0
1734,"Clarke County, Alabama",11403,682,680,496,695,640,785,521,1,25,01025,1709,1881,3120,2047,1782,2159,3511,2632,3491,4040,6631,4679,24128,11403,12725,12781,11044,104,0,79,37404,3152,13031.0,13102.0
1735,"Fayette County, Alabama",8138,475,567,325,401,335,541,290,1,57,01057,1140,1374,2208,1503,1118,1478,2258,1935,2258,2852,4466,3438,16494,8138,8356,14068,1948,78,0,297,39856,2935,8249.0,8756.0
1736,"Rock County, Nebraska",736,49,27,20,54,20,21,23,31,149,31149,119,122,201,146,91,91,169,209,210,213,370,355,1414,736,678,1371,21,0,11,17,56250,318,798.0,841.0
1737,"Sherman County, Nebraska",1531,81,96,53,70,65,104,58,31,163,31163,157,244,425,373,150,192,425,438,307,436,850,811,3033,1531,1502,2966,5,9,24,68,50781,751,1573.0,1680.0
1738,"Beauregard Parish, Louisiana",18833,1265,994,867,1220,997,1446,779,22,11,22011,3141,3771,4582,2598,2515,3388,4763,3102,5656,7159,9345,5700,37043,18833,18210,30920,4620,180,100,1387,53209,7316,15078.0,16357.0
1739,"Bienville Parish, Louisiana",6397,412,445,170,420,282,561,371,22,13,22013,950,1048,1788,1173,923,1154,1875,1581,1873,2202,3663,2754,13564,6397,7167,7428,5858,5,146,83,30272,1966,7005.0,7049.0
1740,"Bossier Parish, Louisiana",62397,4390,4100,2611,4391,4898,3747,2497,22,15,22015,11152,13327,14358,7572,9869,13279,15517,9904,21021,26606,29875,17476,126499,62397,64102,90919,28793,2395,1197,8392,54268,21777,49848.0,54642.0
1741,"Cameron Parish, Louisiana",3355,157,186,224,251,85,348,117,22,23,22023,487,494,1096,510,453,520,1203,598,940,1014,2299,1108,6930,3355,3575,6432,235,36,93,408,53423,1290,3692.0,4039.0
1742,"East Feliciana Parish, Louisiana",10783,568,457,395,359,477,487,251,22,37,22037,1729,2269,3235,1602,1135,1459,2719,1701,2864,3728,5954,3303,19371,10783,8588,10556,8441,66,39,323,51803,3031,10042.0,10509.0
1743,"St. John the Baptist Parish, Louisiana",21197,1508,1611,909,1333,1525,1466,962,22,95,22095,3590,3817,5538,2818,3289,4160,6192,3118,6879,7977,11730,5936,43242,21197,22045,16501,24433,482,1163,2634,57429,6136,20743.0,21431.0
1744,"Plaquemines Parish, Louisiana",11744,754,767,547,833,851,722,429,22,75,22075,1785,2175,3166,1356,1710,2249,3114,1686,3495,4424,6280,3042,23338,11744,11594,15858,4733,901,426,1711,57204,3695,10573.0,11012.0
1745,"Ouachita Parish, Louisiana",74589,5483,5898,3448,5325,5594,5014,3232,22,73,22073,13196,14214,17799,9510,13766,15431,19567,12976,26962,29645,37366,22486,155494,74589,80905,91884,58219,1558,1580,3446,41121,25017,68017.0,69166.0
1746,"Washington Parish, Louisiana",22925,1554,1614,1031,1463,1729,1243,985,22,117,22117,3402,4288,5857,3617,3210,4259,6103,4518,6612,8547,11960,8135,46435,22925,23510,31086,14032,52,381,1058,37570,7773,18628.0,19513.0
1747,"St. Landry Parish, Louisiana",40138,3132,2963,1890,3015,2850,3180,1772,22,97,22097,6210,6801,9939,5685,6268,7510,11017,7422,12478,14311,20956,13107,83172,40138,43034,46586,34551,60,494,1837,36403,12180,39977.0,41154.0
1748,"Acadia Parish, Louisiana",30442,2272,2253,1396,2101,2443,2090,1330,22,1,22001,4751,5564,7676,4063,4576,5954,8304,5217,9327,11518,15980,9280,62457,30442,32015,49556,10841,55,187,1595,43396,10305,27389.0,28425.0
1749,"St. Mary Parish, Louisiana",25211,1842,1581,1024,1670,1480,1760,1023,22,101,22101,3926,4397,6724,3754,3841,4571,6973,4439,7767,8968,13697,8193,50968,25211,25757,30016,15531,734,1649,3585,40485,7859,22877.0,23186.0
1750,"St. Tammany Parish, Louisiana",123830,7660,7977,5645,7653,7839,9350,5508,22,103,22103,16918,23009,33921,18880,16636,24641,36755,22943,33554,47650,70676,41823,255155,123830,131325,211276,30925,4135,2539,14329,68905,51633,124392.0,140110.0
1751,"Union Parish, Louisiana",11150,656,653,483,629,716,601,418,22,111,22111,1523,1948,2985,2124,1436,1820,3183,2400,2959,3768,6168,4524,22353,11150,11203,15986,5533,33,352,1049,44100,4786,10894.0,11201.0
1752,"Caddo Parish, Louisiana",116446,8439,8045,4795,8363,7551,8456,4793,22,17,22017,19049,22020,28558,17148,19759,24189,32821,23453,38808,46209,61379,40601,245831,116446,129385,113489,120925,3166,2168,6942,41797,38790,105804.0,104699.0
1753,"Ascension Parish, Louisiana",60828,4591,4859,2844,4147,5097,3985,2808,22,5,22005,9352,12878,15127,6276,8882,13749,15884,7734,18234,26627,31011,14010,123114,60828,62286,88833,26779,1297,2229,6900,80527,22178,54678.0,62325.0
1754,"Lafayette Parish, Louisiana",117992,8512,7976,4715,8157,8446,7151,4533,22,55,22055,21579,25676,28228,13293,21769,25549,30937,17439,43348,51225,59165,30732,241973,117992,123981,167836,62785,4529,1996,11132,56999,49645,105603.0,114521.0
1755,"Iberia Parish, Louisiana",35150,2534,2584,1606,2687,2575,2638,1510,22,45,22045,5619,6324,9076,4663,5578,6408,9604,5737,11197,12732,18680,10400,71887,35150,36737,43640,22780,1967,1252,3027,46861,10764,32454.0,32713.0
1756,"Lincoln Parish, Louisiana",22972,1427,1303,792,1282,1178,1381,854,22,61,22061,7650,3687,4150,2671,7401,3748,4772,3658,15051,7435,8922,6329,47246,22972,24274,25624,19307,789,867,1447,35467,8330,18669.0,19275.0
1757,"St. Helena Parish, Louisiana",4977,335,225,133,220,447,173,238,22,91,22091,867,969,1166,856,808,1084,1265,1085,1675,2053,2431,1941,10297,4977,5320,4709,5409,26,21,184,43886,1800,5964.0,6158.0
1758,"Webster Parish, Louisiana",19171,1223,1025,791,1145,1210,1198,721,22,119,22119,2952,3250,5080,3286,2704,3433,5379,4281,5656,6683,10459,7567,39242,19171,20071,24993,13346,106,25,761,28951,6812,18145.0,18215.0
1759,"De Soto Parish, Louisiana",13298,947,1105,570,818,871,904,568,22,31,22031,1823,2433,3444,2065,1853,2669,3674,2634,3676,5102,7118,4699,27289,13298,13991,16770,9663,27,26,785,46006,4932,13500.0,14736.0
1760,"Iberville Parish, Louisiana",16535,902,1006,602,931,757,1081,584,22,47,22047,2832,3448,4490,2183,2508,3234,4402,2790,5340,6682,8892,4973,32822,16535,16287,16282,15833,14,167,855,50161,4494,16043.0,16719.0
1761,"Livingston Parish, Louisiana",68224,4746,5244,2861,4476,4678,5431,3203,22,63,22063,10598,14443,17001,8032,10502,15140,17365,9909,21100,29583,34366,17941,138928,68224,70704,125510,8305,867,1150,5195,63389,28101,57730.0,65230.0
1762,"Morehouse Parish, Louisiana",12309,911,906,515,820,1123,585,516,22,67,22067,1918,2096,3096,2012,1792,2251,3560,2654,3710,4347,6656,4666,25610,12309,13301,12664,12583,129,73,146,32929,3635,11852.0,11574.0
1763,"Orleans Parish, Louisiana",185513,11839,11681,6174,11273,10850,10658,5997,22,71,22071,33237,41853,47041,23655,36937,45915,52076,31626,70174,87768,99117,55281,390845,185513,205332,132643,232660,11361,5856,21413,41604,77598,165812.0,177670.0
1764,"Terrebonne Parish, Louisiana",55354,4185,3645,2299,3723,3882,4100,2282,22,109,22109,8962,10970,13835,6962,8726,10933,14489,8565,17688,21903,28324,15527,112054,55354,56700,78715,21311,1111,1525,5773,48747,17834,43896.0,46240.0
1765,"Calcasieu Parish, Louisiana",98398,7332,7157,4124,7012,7307,6406,3971,22,19,22019,16785,19020,23915,13058,16751,19676,25774,16324,33536,38696,49689,29382,201619,98398,103221,141058,50148,2842,2045,7279,51148,35947,83785.0,82663.0
1766,"Claiborne Parish, Louisiana",9131,381,425,281,416,481,280,210,22,27,22027,1768,2112,2382,1364,869,1047,1901,1650,2637,3159,4283,3014,15985,9131,6854,7279,8314,22,126,242,26776,2286,6421.0,6580.0
1767,"Avoyelles Parish, Louisiana",20490,1442,1075,814,1271,989,1559,823,22,9,22009,3311,4188,5066,2960,2902,3568,5230,3837,6213,7756,10296,6797,40669,20490,20179,26967,10942,214,130,786,38565,6468,16586.0,17292.0
1768,"Jackson Parish, Louisiana",8052,448,457,267,435,459,531,232,22,49,22049,1295,1541,2075,1405,975,1394,2018,1783,2270,2935,4093,3188,15879,8052,7827,10770,4719,92,214,263,39139,2757,7464.0,7632.0
1769,"Pointe Coupee Parish, Louisiana",10574,749,801,327,556,601,760,533,22,77,22077,1472,1815,2873,1957,1511,1795,3199,2487,2983,3610,6072,4444,22016,10574,11442,13636,7873,56,242,573,41480,3220,11761.0,12371.0
1770,"St. Charles Parish, Louisiana",26406,1972,1823,1254,1282,1912,1576,1144,22,89,22089,4004,4860,7223,3232,3914,5229,7662,3648,7918,10089,14885,6880,52773,26406,26367,36542,14059,528,899,3233,69019,10298,26192.0,28517.0
1771,"Lafourche Parish, Louisiana",48217,3180,3016,1928,3129,3209,3198,1723,22,57,22057,7867,9313,12812,6563,7972,9234,13232,8194,15839,18547,26044,14757,98108,48217,49891,77504,13371,575,1837,4280,55506,18051,41645.0,45388.0
1772,"Tensas Parish, Louisiana",2247,172,70,118,129,162,116,71,22,107,22107,265,391,508,476,251,356,621,608,516,747,1129,1084,4561,2247,2314,1979,2525,5,50,94,27500,512,2548.0,2554.0
1773,"LaSalle Parish, Louisiana",7783,449,402,374,430,459,531,318,22,59,22059,1408,1584,1894,1125,1020,1244,1782,1369,2428,2828,3676,2494,14936,7783,7153,12570,1695,179,156,422,42104,2737,6569.0,6982.0
1774,"Lincoln County, Maine",16761,706,956,590,660,875,661,482,23,15,23015,2010,2497,4960,4251,1859,2553,5338,5012,3869,5050,10298,9263,34201,16761,17440,33143,129,340,74,426,57720,9266,21503.0,22142.0
1775,"Waldo County, Maine",19409,947,1021,705,848,1005,1045,650,23,27,23027,2541,3281,5649,4068,2416,3487,6134,4545,4957,6768,11783,8613,39539,19409,20130,38044,234,182,155,586,51931,10041,22707.0,23905.0
1776,"Piscataquis County, Maine",8408,360,366,355,360,415,400,278,23,21,23021,873,1191,2667,2220,830,1280,2726,2139,1703,2471,5393,4359,16836,8408,8428,16128,96,131,119,245,40890,4176,9182.0,9224.0
1777,"Aroostook County, Maine",33546,1749,1695,1252,1607,1573,1715,1090,23,3,23003,4379,5169,10245,7255,4065,5213,10374,8626,8444,10382,20619,15881,67809,33546,34263,64373,682,318,96,834,41123,14842,35097.0,33686.0
1778,"Washington County, Maine",15468,779,887,535,716,661,1046,542,23,29,23029,1924,2337,4670,3509,1869,2441,4775,3973,3793,4778,9445,7482,31491,15468,16023,28604,244,149,149,743,41347,7087,16365.0,11346.0
1779,"Knox County, Maine",19815,909,1039,702,849,912,990,613,23,13,23013,2453,3372,5786,4387,2100,3153,6067,5260,4553,6525,11853,9647,39759,19815,19944,38200,205,201,108,600,57751,10608,23147.0,25303.0
1780,"Sagadahoc County, Maine",17339,921,1082,604,873,903,903,632,23,23,23023,2108,2939,5311,3547,1968,3100,5553,4181,4076,6039,10864,7728,35452,17339,18113,33941,278,271,58,609,63694,9017,21616.0,24042.0
1781,"Kennebec County, Maine",59400,3057,3157,2167,2856,2815,3708,2118,23,11,23011,8702,10332,17616,10638,8483,10770,18596,13007,17185,21102,36212,23645,121753,59400,62353,116530,1039,1108,224,1900,55365,28175,66208.0,70029.0
1782,"Franklin County, Maine",14700,744,682,536,654,746,763,485,23,7,23007,2251,2225,4351,3105,2399,2340,4563,3332,4650,4565,8914,6437,29982,14700,15282,28920,73,113,69,389,51422,7356,16488.0,14635.0
1783,"Hancock County, Maine",26374,1180,1354,812,1244,1377,1296,829,23,9,23009,3392,4286,7986,6023,3146,4450,8779,7106,6538,8736,16765,13129,54601,26374,28227,52344,469,624,65,794,57178,14611,32130.0,33035.0
1784,"Baltimore city, Maryland",286048,19919,17382,9382,19140,17609,15900,9387,24,510,24510,57805,61724,69461,33271,62911,68051,80536,49450,120716,129775,149997,82721,609032,286048,322984,185489,379751,15693,10972,32183,50379,109075,239402.0,189549.0
1785,"Somerset County, Maryland",13926,669,709,310,575,602,598,404,24,39,24039,3560,2804,3357,1929,2706,1680,2993,2245,6266,4484,6350,4174,25729,13926,11803,13569,10910,253,271,930,37803,3791,9900.0,9073.0
1786,"Harford County, Maryland",123549,7234,7935,5657,6897,7569,7986,4892,24,25,24025,18641,22976,35241,17467,17532,23867,37549,22381,36173,46843,72790,39848,252222,123549,128673,198359,34843,6571,3508,11489,89147,56326,133672.0,115796.0
1787,"Allegany County, Maryland",37335,1709,1782,1214,1504,1594,1710,1057,24,1,24001,7324,7212,9976,6239,6105,5299,8911,7930,13429,12511,18887,14169,71445,37335,34110,62992,5796,670,206,1277,45893,15072,30654.0,28419.0
1788,"Howard County, Nebraska",3257,215,204,130,175,224,215,109,31,93,31093,358,562,871,636,354,530,835,718,712,1092,1706,1354,6417,3257,3160,6196,10,14,93,163,59348,1536,2994.0,3501.0
1789,"Gosper County, Nebraska",1039,51,52,55,26,16,32,35,31,73,31073,74,133,341,248,111,143,333,278,185,276,674,526,2013,1039,974,1964,5,7,1,101,64053,491,1010.0,1118.0
1790,"Sarpy County, Nebraska",90695,6806,7566,4086,6497,7280,6602,3985,31,153,31153,14818,19776,21279,9204,13258,19758,21742,11415,28076,39534,43021,20619,181232,90695,90537,158414,7120,4627,3647,16896,82032,36571,80580.0,95409.0
1791,"Boyd County, Nebraska",963,39,44,41,38,41,89,35,31,15,31015,69,121,287,295,84,121,277,289,153,242,564,584,1937,963,974,1855,11,19,3,18,47778,459,1156.0,1153.0
1792,"Fillmore County, Nebraska",2748,144,156,102,126,138,149,143,31,59,31059,330,466,822,571,328,411,795,709,658,877,1617,1280,5547,2748,2799,5374,21,31,24,218,60313,1187,2941.0,3134.0
1793,"Hooker County, Nebraska",324,11,4,11,14,17,31,18,31,91,31091,66,21,91,111,37,43,94,115,103,64,185,226,693,324,369,677,7,0,5,45,41125,183,417.0,442.0
1794,"Seward County, Nebraska",8746,528,592,359,484,591,518,346,31,159,31159,1738,1442,2174,1326,1377,1415,2108,1586,3115,2857,4282,2912,17171,8746,8425,16550,96,84,92,452,70389,3170,7922.0,9142.0
1795,"Webster County, Nebraska",1787,115,128,59,82,91,155,66,31,181,31181,260,260,504,351,203,236,476,441,463,496,980,792,3537,1787,1750,3375,10,0,17,181,46188,777,1708.0,1876.0
1796,"Butler County, Nebraska",4003,201,241,195,273,290,241,181,31,23,31023,516,703,1121,746,433,611,1101,896,949,1314,2222,1642,8029,4003,4026,7739,12,56,68,287,58979,1796,3981.0,4478.0
1797,"Arthur County, Nebraska",203,9,23,7,6,25,22,8,31,5,31005,24,33,43,45,8,26,67,62,32,59,110,107,427,203,224,411,0,0,2,2,42813,81,273.0,284.0
1798,"Gage County, Nebraska",10854,677,658,442,570,607,700,391,31,67,31067,1326,1871,3027,2015,1248,1796,3014,2414,2574,3667,6041,4429,21594,10854,10740,20839,130,143,100,548,53110,4668,10048.0,11068.0
1799,"Kearney County, Nebraska",3236,234,219,123,186,260,217,149,31,99,31099,431,584,835,562,372,549,883,677,803,1133,1718,1239,6529,3236,3293,6314,7,32,27,410,60266,1305,3296.0,3591.0
1800,"Madison County, Nebraska",17447,1261,1006,691,1313,1223,1155,679,31,119,31119,2932,3188,4451,2430,2738,3132,4371,3022,5670,6320,8822,5452,35080,17447,17633,32143,458,602,866,5267,53188,6144,14343.0,15407.0
1801,"Phelps County, Nebraska",4562,292,443,188,234,234,349,198,31,137,31137,619,805,1218,781,522,720,1241,1040,1141,1525,2459,1821,9100,4562,4538,8771,33,14,70,519,59040,1709,4695.0,5009.0
1802,"Wayne County, Nebraska",4742,231,311,214,246,205,263,126,31,179,31179,1288,727,1020,666,1278,716,975,781,2566,1443,1995,1447,9332,4742,4590,8898,135,43,51,557,56456,1664,3776.0,4200.0
1803,"Knox County, Nebraska",4177,284,259,184,258,255,323,168,31,107,31107,472,632,1127,916,459,567,1074,1145,931,1199,2201,2061,8426,4177,4249,7316,34,27,59,242,52332,1747,4115.0,4693.0
1804,"Merrick County, Nebraska",3916,246,239,158,246,230,252,145,31,121,31121,484,664,1139,765,474,662,1021,852,958,1326,2160,1617,7798,3916,3882,7410,37,40,130,349,55649,1606,3788.0,4267.0
1805,"Pawnee County, Nebraska",1262,80,79,25,83,78,66,68,31,133,31133,148,173,349,334,130,183,375,404,278,356,724,738,2649,1262,1387,2558,4,0,0,48,46452,504,1327.0,1429.0
1806,"Wheeler County, Nebraska",413,31,24,13,35,23,6,8,31,183,31183,32,71,144,81,36,52,104,106,68,123,248,187,783,413,370,776,0,2,3,20,51591,208,465.0,502.0
1807,"Lander County, Nevada",3091,109,320,111,201,230,131,93,32,15,32015,395,660,844,326,224,491,710,472,619,1151,1554,798,5643,3091,2552,5265,52,6,28,1759,88030,745,2413.0,2653.0
1808,"Esmeralda County, Nevada",425,5,27,4,23,46,37,4,32,9,32009,22,71,122,159,20,111,186,117,42,182,308,276,969,425,544,927,25,0,0,153,37375,178,423.0,474.0
1809,"Mineral County, Nevada",2216,123,134,77,64,86,156,74,32,21,32021,229,246,582,712,346,303,568,647,575,549,1150,1359,4460,2216,2244,3040,229,57,81,519,35806,596,1997.0,2179.0
1810,"Lincoln County, Nevada",2790,42,69,140,152,146,87,101,32,17,32017,564,486,664,627,304,367,726,507,868,853,1390,1134,5180,2790,2390,4589,232,46,215,357,58462,960,2132.0,2312.0
1811,"Washoe County, Nevada",230091,13884,14030,8594,13355,13324,13875,7956,32,31,32031,39276,45166,59569,34868,37481,43279,59553,38022,76757,88445,119122,72890,456936,230091,226845,354407,10630,24401,37237,111653,64791,86563,209909.0,244132.0
1812,"Carson City, Nevada",28133,1497,1587,977,1474,1623,1419,965,32,510,32510,4265,5284,7890,4956,3572,4368,7318,5901,7837,9652,15208,10857,54773,28133,26640,44913,1125,1465,4593,13226,55718,8819,25016.0,29126.0
1813,"Merrimack County, New Hampshire",73860,3614,4181,2826,3520,4066,3985,2735,33,13,33013,11926,13443,21992,11756,11230,13087,22874,14560,23156,26530,44866,26316,149917,73860,76057,141017,2139,3135,576,3233,75737,36621,83648.0,89477.0
1814,"Belknap County, New Hampshire",30002,1308,1459,1157,1360,1243,2009,1000,33,1,33001,3940,4735,9357,6183,3619,5034,9766,6854,7559,9769,19123,13037,60887,30002,30885,58664,400,569,97,1018,69447,15148,35045.0,38387.0
1815,"Strafford County, New Hampshire",63204,3018,3344,2144,3066,3268,3399,2171,33,17,33017,14334,11330,16875,8397,14849,11253,17473,10441,29183,22583,34348,18838,129124,63204,65920,119599,1284,4331,391,3231,72960,27481,69000.0,73676.0
1816,"Monmouth County, New Jersey",302256,15663,18244,13260,15154,18863,18558,12907,34,25,34025,44343,50999,92846,46409,41968,52970,98790,60193,86311,103969,191636,106602,621659,302256,319403,512161,44513,33559,17668,67168,99733,153306,314377.0,292654.0
1817,"Sussex County, New Jersey",70411,3283,3657,3060,3035,3730,4175,2865,34,37,34037,10223,11703,22943,10909,9320,11597,23596,12754,19543,23300,46539,23663,141483,70411,71072,131300,3290,2963,1354,11617,94520,35858,74126.0,68327.0
1818,"Essex County, New Jersey",382523,26884,26717,15714,25831,24669,27040,15300,34,13,34013,63163,79525,99672,43637,63005,84682,109073,63281,126168,164207,208745,106918,795404,382523,412881,341516,315997,42406,72050,183182,61510,161294,310934.0,291105.0
1819,"Gloucester County, New Jersey",141404,7807,9293,6226,7566,9097,9019,5885,34,15,34015,22687,25981,40424,19473,21456,27831,43586,25321,44143,53812,84010,44794,291165,141404,149761,237131,29570,9045,5713,18059,87283,68436,139542.0,168093.0
1820,"Passaic County, New Jersey",245332,17467,16669,10225,16756,15564,16831,9861,34,31,34031,42150,47723,63410,30580,42169,48503,67304,41317,84319,96226,130714,71897,503637,245332,258305,322127,56399,26084,83742,209203,69688,94503,194802.0,139854.0
1821,"Bergen County, New Jersey",451161,25044,27994,18717,24259,27115,27886,17866,34,3,34003,64240,87764,129581,68448,62361,90896,138879,89967,126601,178660,268460,158415,930390,451161,479229,666126,55381,151965,30023,185238,101144,269402,419296.0,448647.0
1822,"Warren County, New Jersey",51835,2379,3003,2272,2398,2739,3257,2030,34,41,34041,7795,8734,16343,8209,7261,8805,17108,10429,15056,17539,33451,18638,105862,51835,54027,93685,4747,2812,1907,9817,81307,25323,49236.0,43985.0
1823,"Burlington County, New Jersey",219200,11783,13030,8889,11289,12887,13444,8544,34,5,34005,35575,40891,63049,31980,30318,41054,66778,42188,65893,81945,129827,74168,445702,219200,226502,320997,75266,22583,8821,35855,87416,106703,218943.0,214299.0
1824,"Luna County, New Mexico",12026,924,821,453,865,779,1005,542,35,29,35029,1923,1993,2584,2355,1736,1839,2707,2584,3659,3832,5291,4939,24083,12026,12057,22231,381,199,740,16151,29360,3945,7295.0,8103.0
1825,"Taos County, New Mexico",16137,710,812,543,753,965,694,506,35,55,35055,1978,2655,4695,3812,1864,2546,4853,4468,3842,5201,9548,8280,32786,16137,16649,27682,154,282,1793,18652,38329,6701,15260.0,16790.0
1826,"Colfax County, New Mexico",6256,303,402,310,286,341,270,76,35,7,35007,815,1002,1622,1546,655,818,1726,1740,1470,1820,3348,3286,12168,6256,5912,10394,89,52,882,6011,36302,2357,5332.0,6016.0
1827,"Harding County, New Mexico",242,0,1,7,18,16,13,2,35,21,35021,17,26,65,122,32,19,49,50,49,45,114,172,441,242,199,363,0,0,59,175,29375,93,527.0,505.0
1828,"Quay County, New Mexico",3976,180,299,102,308,354,236,140,35,37,35037,427,818,934,947,442,757,1039,1074,869,1575,1973,2021,8326,3976,4350,7373,138,75,458,3771,29035,1446,3572.0,3873.0
1829,"Noxubee County, Mississippi",4993,386,395,259,397,291,409,309,28,103,28103,873,865,1263,717,911,843,1558,989,1784,1708,2821,1706,10700,4993,5707,2916,7721,5,0,150,33784,1084,5574.0,3981.0
1830,"Tate County, Mississippi",13676,841,878,624,796,989,862,575,28,137,28137,2486,2327,3486,2026,2487,2602,3863,2554,4973,4929,7349,4580,28404,13676,14728,18895,8494,41,164,747,51030,3970,11627.0,8420.0
1831,"Panola County, Mississippi",16482,1279,1232,737,1196,1103,1173,697,28,107,28107,2820,2768,4190,2302,2671,3282,4639,2947,5491,6050,8829,5249,34190,16482,17708,16647,16616,5,49,699,38304,4807,15064.0,15421.0
1832,"Yalobusha County, Mississippi",5982,422,409,270,349,359,389,203,28,161,28161,837,956,1602,1093,882,1058,1799,1346,1719,2014,3401,2439,12367,5982,6385,7302,4904,19,32,172,41464,1527,6077.0,6506.0
1833,"Winnebago County, Iowa",5188,271,319,247,294,395,242,223,19,189,19189,884,816,1398,958,754,797,1402,1239,1638,1613,2800,2197,10534,5188,5346,9993,181,134,76,489,49870,2137,5787.0,5931.0
1834,"Shelby County, Iowa",5682,292,453,283,293,369,356,229,19,165,19165,665,863,1641,1173,688,851,1679,1459,1353,1714,3320,2632,11606,5682,5924,11247,88,22,56,345,58000,2552,6370.0,6781.0
1835,"Appanoose County, Iowa",6138,339,442,243,334,383,397,217,19,7,19007,783,947,1728,1278,738,953,1743,1549,1521,1900,3471,2827,12452,6138,6314,12074,89,58,16,250,40167,2455,6136.0,6500.0
1836,"Iowa County, Iowa",8020,499,590,324,449,428,623,317,19,95,19095,1039,1444,2295,1339,955,1457,2295,1645,1994,2901,4590,2984,16189,8020,8169,15664,151,80,77,464,61443,3438,8904.0,9741.0
1837,"Page County, Iowa",7996,381,384,368,402,401,364,243,19,145,19145,1165,1576,2125,1495,861,1182,2009,1810,2026,2758,4134,3305,15268,7996,7272,14313,305,152,65,532,51867,3577,7044.0,7509.0
1838,"Winneshiek County, Iowa",10058,451,427,398,402,574,476,332,19,191,19191,2000,1481,2746,1865,2111,1461,2656,2192,4111,2942,5402,4057,20262,10058,10204,19593,308,132,116,455,65263,4580,11362.0,12034.0
1839,"Pottawattamie County, Iowa",46036,2860,3308,1878,2817,2916,3066,1841,19,155,19155,7052,8371,12291,6971,6701,8343,12806,8867,13753,16714,25097,15838,93393,46036,47357,86816,1638,728,2042,7196,60065,17957,42680.0,45733.0
1840,"Marshall County, Iowa",20308,1399,1495,820,1260,1369,1379,782,19,127,19127,3073,3564,5179,3218,2565,3379,5071,3851,5638,6943,10250,7069,39964,20308,19656,34303,502,1474,2652,8771,56437,6972,17980.0,18122.0
1841,"Boone County, Iowa",13203,724,870,608,797,806,672,460,19,15,19015,1868,2486,3721,2139,1754,2464,3688,2526,3622,4950,7409,4665,26370,13203,13167,25246,168,82,206,695,64000,5512,14196.0,15277.0
1842,"Buena Vista County, Iowa",9999,736,791,479,761,714,702,421,19,21,19021,1747,1814,2471,1371,1788,1666,2351,1656,3535,3480,4822,3027,20058,9999,10059,15451,505,2020,1493,5112,57125,3091,8278.0,8072.0
1843,"Howard County, Iowa",4613,318,365,179,310,339,299,177,19,89,19089,546,763,1232,858,509,748,1223,1008,1055,1511,2455,1866,9226,4613,4613,9051,29,40,1,148,55060,1888,4559.0,4951.0
1844,"Guthrie County, Iowa",5278,284,271,244,280,333,394,209,19,77,19077,599,854,1539,1071,561,826,1501,1287,1160,1680,3040,2358,10669,5278,5391,10321,34,26,86,290,61161,2281,5750.0,6369.0
1845,"Humboldt County, Iowa",4683,265,313,159,306,305,358,177,19,91,19091,568,847,1284,903,525,834,1282,1084,1093,1681,2566,1987,9554,4683,4871,9300,38,30,42,420,54575,2075,5087.0,5320.0
1846,"Madison County, Iowa",8101,505,615,376,413,561,510,349,19,121,19121,893,1483,2283,1312,960,1426,2269,1423,1853,2909,4552,2735,16012,8101,7911,15536,38,226,5,327,66316,3511,8636.0,9795.0
1847,"Guaynabo Municipio, Puerto Rico",40939,1707,2051,1534,1616,2028,2051,1446,72,61,72061,7109,7897,10804,7653,6471,8094,13380,10912,13580,15991,24184,18565,86937,40939,45998,65520,6236,44,11421,85548,35928,22353,,
1848,"Fajardo Municipio, Puerto Rico",14504,738,831,614,727,836,925,595,72,53,72053,2611,2411,3459,2864,2650,2856,4208,3810,5261,5267,7667,6674,31111,14504,16607,17461,3355,142,9157,30812,19430,6294,,
1849,"Aguas Buenas Municipio, Puerto Rico",12480,507,625,540,506,649,829,509,72,7,72007,2116,2357,3204,2211,2032,2454,3628,2661,4148,4811,6832,4872,25748,12480,13268,14050,2372,0,642,25659,19279,4221,,
1850,"Hatillo Municipio, Puerto Rico",19174,743,922,779,771,1011,1149,736,72,65,72065,3148,3612,5040,3503,3102,4006,5718,4283,6250,7618,10758,7786,39950,19174,20776,38979,323,24,403,39803,17715,8157,,
1851,"Santa Isabel Municipio, Puerto Rico",10496,516,586,516,485,523,890,463,72,133,72133,1809,2072,2565,1585,1906,2425,2710,1859,3715,4497,5275,3444,21757,10496,11261,12622,8122,0,720,21660,19827,4662,,
1852,"Mayagüez Municipio, Puerto Rico",35879,1494,2212,1436,1421,1588,2086,1327,72,97,72097,8489,5487,7938,7175,7632,5688,9271,10340,16121,11175,17209,17515,75232,35879,39353,20489,2600,39,50281,74610,14236,12958,,
1853,"Río Grande Municipio, Puerto Rico",23868,1026,1344,1000,989,1346,1363,986,72,119,72119,4333,4436,5980,4227,4070,4673,6954,5364,8403,9109,12934,9591,49613,23868,25745,25770,6574,154,15973,49182,22669,9946,,
1854,"Añasco Municipio, Puerto Rico",13016,515,723,537,513,620,797,493,72,11,72011,2207,2394,3447,2388,2075,2520,3937,2963,4282,4914,7384,5351,26934,13016,13918,22150,522,0,2174,25616,19919,4624,,
1855,"Cataño Municipio, Puerto Rico",11461,580,881,493,532,699,680,500,72,33,72033,1985,2089,2877,1958,2064,2284,3397,2654,4049,4373,6274,4612,24271,11461,12810,16520,3181,48,3578,24026,17448,3907,,
1856,"Guánica Municipio, Puerto Rico",7853,421,323,315,389,314,612,287,72,55,72055,1210,1332,1824,1778,1265,1480,2103,1990,2475,2812,3927,3768,16293,7853,8440,9325,847,0,5896,16127,12995,2730,,
1857,"Loíza Municipio, Puerto Rico",12001,557,971,506,554,743,875,521,72,87,72087,2079,2159,3098,1942,2388,2556,3703,2437,4467,4715,6801,4379,25778,12001,13777,6252,9983,73,9323,25704,17852,3295,,
1858,"Las Piedras Municipio, Puerto Rico",18022,805,922,785,765,972,1188,719,72,85,72085,2844,3640,4484,3057,3082,4160,5165,3426,5926,7800,9649,6483,37499,18022,19477,7645,29056,1,461,37395,21667,6101,,
1859,"Vega Baja Municipio, Puerto Rico",24963,1162,1235,1056,1193,1422,1420,1019,72,145,72145,4253,4502,6391,4522,4159,5007,7373,5636,8412,9509,13764,10158,52192,24963,27229,43427,2589,9,5582,50491,19617,9548,,
1860,"Lafayette County, Arkansas",3440,229,316,142,146,127,125,100,5,73,05073,480,484,933,718,436,508,1054,864,916,992,1987,1582,6800,3440,3360,4077,2448,27,110,182,32397,1053,2860.0,2633.0
1861,"Phillips County, Arkansas",8738,751,779,363,638,296,939,437,5,107,05107,1296,1323,2156,1474,1524,1545,2588,1901,2820,2868,4744,3375,18606,8738,9868,6719,11750,0,39,350,29320,2119,6953.0,6155.0
1862,"Yell County, Arkansas",10755,770,707,489,601,487,930,462,5,149,05149,1518,1932,2847,1701,1402,1876,2907,2044,2920,3808,5754,3745,21464,10755,10709,16873,526,237,3481,4326,43923,3759,6439.0,6711.0
1863,"Bradley County, Arkansas",5157,252,416,220,411,429,297,192,5,11,05011,714,920,1380,876,750,1038,1482,1118,1464,1958,2862,1994,10874,5157,5717,7164,3135,7,426,1673,43184,1647,3653.0,3644.0
1864,"Polk County, Arkansas",9720,583,609,473,596,568,804,436,5,113,05113,1297,1571,2502,2082,1246,1588,2709,2427,2543,3159,5211,4509,20094,9720,10374,18409,95,57,548,1324,37974,3639,8231.0,8468.0
1865,"Ouachita County, Arkansas",11371,790,758,574,658,543,1013,303,5,103,05103,1539,1776,3137,2005,1671,2026,3575,2670,3210,3802,6712,4675,23830,11371,12459,13582,9923,18,22,558,35425,3397,9935.0,8993.0
1866,"Little River County, Arkansas",5966,346,307,249,373,373,337,228,5,81,05081,794,1051,1526,1168,772,1173,1746,1379,1566,2224,3272,2547,12347,5966,6381,9124,2710,42,65,189,45113,2207,5227.0,5178.0
1867,"Miller County, Arkansas",21369,1365,1598,961,1379,1438,1261,887,5,91,05091,3425,3943,5512,3086,3149,4196,5843,4050,6574,8139,11355,7136,43572,21369,22203,30408,10789,173,796,1450,43371,6472,16091.0,16506.0
1868,"White County, Arkansas",38474,2577,2357,1544,2305,2359,2659,1651,5,145,05145,6833,6782,9801,5580,7232,6965,10006,7111,14065,13747,19807,12691,78762,38474,40288,71754,3434,583,767,3422,44029,15443,27219.0,30689.0
1869,"Lake County, California",31865,1857,1863,1142,1874,1859,1776,1181,6,33,06033,4145,5270,8786,6954,3703,5098,9460,7379,7848,10368,18246,14333,64195,31865,32330,49389,1447,723,7909,13224,47040,10216,24496.0,11038.0
1870,"Yuba County, California",38950,3097,3123,1692,2896,3189,2473,1469,6,115,06115,7336,7719,8407,4437,6328,7481,8636,4938,13664,15200,17043,9375,76360,38950,37410,58016,2621,5201,3581,21563,58054,10208,22998.0,18820.0
1871,"Lassen County, California",20332,796,534,432,632,598,549,343,6,35,06035,5744,5550,4393,2165,1357,1709,3084,2214,7101,7259,7477,4379,30818,20332,10486,25324,2686,428,510,5844,56352,6091,10524.0,10484.0
1872,"Sonoma County, California",244045,12771,14417,8967,12366,13313,14297,8629,6,97,06097,37580,47522,66420,41938,36244,46547,71356,52975,73824,94069,137776,94913,499772,244045,255727,373667,8269,20443,64631,133569,81018,102003,231253.0,197603.0
1873,"Imperial County, California",92752,7652,6961,4327,7428,6396,7482,4051,6,25,06025,18046,19080,18856,10274,14622,15623,19780,12567,32668,34703,38636,22841,180701,92752,87949,117658,4489,2680,47139,152172,47622,19757,48091.0,36084.0
1874,"Alameda County, California",814515,49611,49375,28149,47238,45905,47993,26979,6,1,06001,138548,193597,208399,98059,137957,194212,215988,125967,276505,387809,424387,224026,1656754,814515,842239,670364,175751,499382,179244,371019,99406,466434,654266.0,498082.0
1875,"Napa County, California",69603,3680,3954,2800,3373,3557,4521,2648,6,55,06055,10522,13436,18517,12026,10146,12867,18966,13942,20668,26303,37483,25968,139623,69603,70020,102467,2883,11352,16044,47544,88596,27860,61372.0,44383.0
1876,"Sierra County, California",1625,100,73,27,23,78,90,27,6,91,06091,150,313,448,450,110,178,467,442,260,491,915,892,3040,1625,1415,2963,2,0,0,324,52148,787,1830.0,1926.0
1877,"Yolo County, California",105438,6163,6495,4059,6149,6003,6740,3831,6,113,06113,28619,19554,22272,11690,31144,19640,23701,14706,59763,39194,45973,26396,217352,105438,111914,150617,5847,30462,14506,68704,70228,43406,82090.0,64934.0
1878,"Nevada County, California",48947,2214,2699,1606,1963,2205,2575,1540,6,57,06057,5663,8113,13954,12401,5020,7867,15274,13853,10683,15980,29228,26254,99244,48947,50297,91726,570,1073,1254,9373,66096,22709,54935.0,40116.0
1879,"Mendocino County, California",43242,2588,2596,1586,2488,2936,2254,1516,6,45,06045,5860,7767,11487,8620,5443,7501,11932,9912,11303,15268,23419,18532,87224,43242,43982,72935,628,1805,3583,21898,51416,16125,37477.0,25171.0
1880,"Los Angeles County, California",4969382,313551,305531,193723,297934,290954,306842,185868,6,37,06037,926021,1086865,1245249,578085,901659,1068430,1302608,757893,1827680,2155295,2547857,1335978,10081570,4969382,5112188,5168443,820478,1473221,2115548,4888434,68044,1962585,3434308.0,3674850.0
1881,"Santa Clara County, California",974422,59811,60829,35944,56697,56665,61122,34350,6,85,06085,169259,225459,247066,113090,149257,209325,244548,141084,318516,434784,491614,254174,1927470,974422,953048,857092,47992,702881,202394,490978,124055,578240,703709.0,644534.0
1882,"Siskiyou County, California",21708,1167,1372,776,1160,1522,863,700,6,93,06093,2709,3434,5790,5194,2408,3185,6384,5538,5117,6619,12174,10732,43468,21708,21760,36847,695,708,636,5467,45241,7786,20492.0,22836.0
1883,"Del Norte County, California",14745,884,787,409,648,702,982,530,6,15,06015,2318,3493,3634,2242,1614,2209,3580,2485,3932,5702,7214,4727,27495,14745,12750,20581,940,888,1320,5429,45283,4844,9558.0,11066.0
1884,"Chaffee County, Colorado",10488,432,481,248,309,266,553,226,8,15,08015,1382,2105,3046,2365,922,1378,2881,2534,2304,3483,5927,4899,19557,10488,9069,18324,330,290,150,1963,55771,5005,11250.0,13620.0
1885,"Garfield County, Colorado",30109,2006,2403,1229,1979,2529,1627,1170,8,45,08045,4457,6567,7832,3578,4135,6076,7531,3899,8592,12643,15363,7477,59055,30109,28946,50833,286,532,5843,16789,75937,11471,26470.0,30274.0
1886,"Jefferson County, Colorado",286412,15264,15792,10557,14616,15957,15538,9981,8,59,08059,45301,61642,79011,41471,40822,58290,82684,50498,86123,119932,161695,91969,574798,286412,288386,520619,6839,16256,10653,88330,82986,140224,328882.0,376430.0
1887,"Rio Blanco County, Colorado",3260,200,396,107,201,225,197,97,8,103,08103,509,555,866,503,500,594,840,470,1009,1149,1706,973,6384,3260,3124,5898,30,8,18,655,54357,1258,3450.0,3672.0
1888,"Conejos County, Colorado",4088,267,301,198,273,245,367,217,8,21,08021,577,653,1049,747,542,602,1028,766,1119,1255,2077,1513,8128,4088,4040,7216,40,15,414,4263,36084,1420,4022.0,4291.0
1889,"Adams County, Colorado",254500,18536,20217,11314,17883,18277,19454,10797,8,1,08001,43614,59741,58779,22917,40803,56055,58151,28188,84417,115796,116930,51105,504108,254500,249608,411153,17014,19930,28040,201784,71202,86647,193665.0,234599.0
1890,"Eagle County, Colorado",29060,1615,1746,1071,1472,1543,1773,968,8,37,08037,4633,6940,8199,3051,3927,6009,7103,2826,8560,12949,15302,5877,54681,29060,25621,48591,642,357,3955,16179,84790,12490,25223.0,28427.0
1891,"Moffat County, Colorado",6797,474,589,286,415,396,443,279,8,81,08081,1155,1172,1748,894,897,1188,1798,914,2052,2360,3546,1808,13127,6797,6330,12388,158,18,150,2044,57229,2687,6525.0,6964.0
1892,"Cheyenne County, Colorado",1012,77,93,60,140,63,64,37,8,17,08017,89,195,299,125,67,171,262,210,156,366,561,335,2026,1012,1014,1894,2,44,0,346,53977,444,1102.0,1105.0
1893,"Montgomery County, Alabama",107049,7757,7381,4436,7589,7650,6896,4307,1,101,01101,19820,20685,25709,13837,20513,23140,30527,19270,40333,43825,56236,33107,226941,107049,119892,81265,131408,6383,3104,7978,50124,42569,95878.0,98476.0
1894,"Marshall County, Alabama",47230,3347,3152,2078,3268,3056,3299,1944,1,95,01095,7253,8488,12188,6981,6645,8628,12461,9112,13898,17116,24649,16093,95643,47230,48413,88969,2549,573,1401,13357,45983,15839,35316.0,39492.0
1895,"Blount County, Alabama",28495,1750,1734,1251,1682,1856,1942,1082,1,9,01009,4141,5271,7647,4609,3863,5328,7716,5717,8004,10599,15363,10326,57681,28495,29186,55062,928,212,492,5342,49358,9548,25588.0,27459.0
1896,"Henry County, Alabama",8319,455,396,355,434,491,474,299,1,67,01067,1135,1430,2205,1651,1043,1525,2414,2134,2178,2955,4619,3785,17133,8319,8814,12118,4565,68,134,449,50017,2714,8072.0,9266.0
1897,"Madison County, Alabama",176935,10826,11099,7139,10424,10710,11068,6925,1,89,01089,30756,33590,48785,23244,30007,34842,51458,29907,60763,68432,100243,53151,362276,176935,185341,246132,88011,9555,4939,17928,65449,78767,163389.0,193955.0
1898,"Autauga County, Alabama",26934,1734,2153,1229,1483,1661,1946,1345,1,1,01001,4238,5169,7163,3594,4172,5591,7559,4689,8410,10760,14722,8283,55380,26934,28446,42527,10538,573,378,1565,58731,9758,24973.0,27639.0
1899,"Tallapoosa County, Alabama",19573,1197,1373,755,1060,1325,1080,725,1,123,01123,2899,2961,5559,3875,2735,3331,6082,4630,5634,6292,11641,8505,40541,19573,20968,28360,11123,145,306,981,45828,6502,19486.0,20888.0
1900,"Geneva County, Alabama",12835,725,899,539,715,817,831,502,1,61,01061,1714,2226,3617,2325,1645,2302,3820,2950,3359,4528,7437,5275,26417,12835,13582,22870,2538,115,210,1051,41732,4427,11758.0,12538.0
1901,"Wilcox County, Alabama",5014,296,177,251,375,302,412,255,1,131,01131,835,864,1194,888,783,931,1471,1138,1618,1795,2665,2026,10681,5014,5667,2915,7410,3,0,57,31014,1013,6118.0,5884.0
1902,"Aleutians West Census Area, Alaska",3380,93,185,55,96,193,139,61,2,16,02016,684,873,1166,164,404,499,743,183,1088,1372,1909,347,5698,3380,2318,1660,191,2295,292,801,87466,895,7436.0,
1903,"Bristol Bay Borough, Alaska",524,29,20,17,19,26,22,24,2,60,02060,77,105,199,54,29,65,133,33,106,170,332,87,875,524,351,461,5,2,14,32,79808,181,,
1904,"Kodiak Island Borough, Alaska",7221,486,582,287,505,592,237,251,2,150,02150,1337,1522,1840,646,1073,1444,1455,673,2410,2966,3295,1319,13451,7221,6230,7359,46,3055,194,1198,85839,2267,,
1905,"Northwest Arctic Borough, Alaska",4189,414,421,184,404,370,342,184,2,188,02188,789,761,950,269,705,553,662,306,1494,1314,1612,575,7715,4189,3526,870,94,77,37,112,60906,454,,
1906,"McMinn County, Tennessee",25838,1439,1427,1043,1464,1279,1823,1018,47,107,47107,3688,4581,7232,4673,3686,4828,7514,5603,7374,9409,14746,10276,53053,25838,27215,49050,1953,415,311,2130,43285,10280,18755.0,22815.0
1907,"Marshall County, Tennessee",16235,1064,1132,781,924,1079,977,718,47,117,47117,2317,3137,4371,2307,2270,3259,4627,2876,4587,6396,8998,5183,32965,16235,16730,29548,2491,106,338,1778,53197,5907,11455.0,14862.0
1908,"Rhea County, Tennessee",16199,1103,1131,708,1028,995,1163,567,47,143,47143,2600,2771,4280,2709,2417,2794,4382,3174,5017,5565,8662,5883,32719,16199,16520,30879,746,156,232,1620,42206,6071,11062.0,13608.0
1909,"Scott County, Tennessee",10857,697,675,471,640,812,667,491,47,151,47151,1590,2055,2865,1649,1511,2032,2975,1984,3101,4087,5840,3633,21969,10857,11112,21487,126,2,20,212,38864,4419,7123.0,9052.0
1910,"Anderson County, Tennessee",37152,2192,2324,1475,1923,2154,2330,1421,47,1,47001,5418,6581,10294,6597,5069,6526,11096,8390,10487,13107,21390,14987,76061,37152,38909,69131,2671,982,770,2215,50392,14555,29881.0,35527.0
1911,"Fentress County, Tennessee",9084,519,587,380,521,555,452,343,47,49,47049,1232,1481,2622,1768,1074,1420,2700,2064,2306,2901,5322,3832,18213,9084,9129,17718,59,100,63,278,36520,4012,7333.0,8687.0
1912,"Gibson County, Tennessee",23623,1558,1745,982,1530,1647,1578,1148,47,53,47053,3442,4247,6266,3690,3392,4672,6618,5020,6834,8919,12884,8710,49228,23623,25605,38519,8423,156,251,1339,43171,8419,19547.0,22336.0
1913,"Hardeman County, Tennessee",14252,577,754,431,440,532,810,434,47,69,47069,2709,3245,3623,2068,1489,1869,3133,2484,4198,5114,6756,4552,25443,14252,11191,14022,10648,187,166,447,40304,4272,9273.0,10058.0
1914,"Loudon County, Tennessee",25614,1381,1544,906,1306,1344,1548,880,47,105,47105,3173,3878,6980,6365,3068,4045,7378,7157,6241,7923,14358,13522,52340,25614,26726,49169,510,375,1161,4595,58065,10123,23391.0,29375.0
1915,"Rutherford County, Tennessee",155575,10582,11306,6778,10104,10326,11310,6471,47,149,47149,32252,32779,36383,14199,31378,34102,38543,18006,63630,66881,74926,32205,315815,155575,160240,242518,46723,10850,4521,25329,67429,62185,107436.0,143888.0
1916,"Smith County, Tennessee",9868,615,528,416,509,686,494,437,47,159,47159,1395,1677,2888,1453,1327,1757,2885,1777,2722,3434,5773,3230,19740,9868,9872,18433,561,74,219,537,48068,4283,7436.0,9035.0
1917,"Wilson County, Tennessee",67205,4238,4374,2923,3888,4943,4192,2746,47,189,47189,9097,13214,18548,9607,8869,13926,19429,11468,17966,27140,37977,21075,136666,67205,69461,119957,9757,2256,1929,5784,75991,29380,56734.0,74096.0
1918,"Unicoi County, Tennessee",9006,358,479,293,366,388,416,291,47,171,47171,1383,1541,2570,1888,1098,1376,2630,2240,2481,2917,5200,4128,17811,9006,8805,17170,60,50,236,873,41890,3360,7195.0,8294.0
1919,"Lincoln County, New Mexico",9554,488,416,306,426,521,463,301,35,27,35027,1091,1374,2585,2634,980,1476,2899,2841,2071,2850,5484,5475,19461,9554,9907,18843,104,13,163,6458,46216,4304,8902.0,10306.0
1920,"Chaves County, New Mexico",32537,2303,2428,1749,2116,2694,2071,1455,35,5,35005,5529,5744,7558,4603,4975,5864,7935,5497,10504,11608,15493,10100,65144,32537,32607,57038,1012,621,3823,36967,43359,9500,20271.0,22443.0
1921,"Lea County, New Mexico",36269,2839,2989,1705,2683,3092,2823,1599,35,25,35025,6373,7498,7960,3494,5585,6675,7275,4276,11958,14173,15235,7770,70277,36269,34008,62117,2692,402,3111,41230,60546,10019,17712.0,20918.0
1922,"Santa Fe County, New Mexico",72380,3354,4007,2463,3149,3582,4445,2551,35,49,35049,9751,12937,20145,15784,9436,12539,22457,18754,19187,25476,42602,34538,149293,72380,76913,125090,1574,1889,11617,76446,61200,36236,71434.0,81213.0
1923,"Union County, New Mexico",2221,72,205,10,154,179,114,65,35,59,35059,344,624,582,347,153,334,444,469,497,958,1026,816,4133,2221,1912,3583,67,1,222,1750,35884,942,1702.0,1789.0
1924,"Sierra County, New Mexico",5463,344,132,188,153,287,332,86,35,51,35051,558,685,1373,1962,502,609,1640,1959,1060,1294,3013,3921,11031,5463,5568,9907,44,83,229,3348,29755,2326,5181.0,5945.0
1925,"Socorro County, New Mexico",8815,526,532,430,275,695,465,187,35,53,35053,1739,1246,2047,1562,1166,1313,2326,1616,2905,2559,4373,3178,16858,8815,8043,13439,95,553,318,8388,42083,3355,6868.0,7159.0
1926,"Roosevelt County, New Mexico",9401,666,590,355,662,770,452,368,35,41,35041,2461,1548,1823,1215,2374,1428,2026,1407,4835,2976,3849,2622,18888,9401,9487,14255,530,121,2838,7956,42702,3030,5950.0,6608.0
1927,"Doña Ana County, New Mexico",106056,7021,7426,4622,6992,7793,7249,4369,35,13,35013,23401,18157,21833,15454,23020,18318,24686,17586,46421,36475,46519,33040,216069,106056,110013,188300,3905,2427,14850,147491,40973,34978,70648.0,82556.0
1928,"Los Alamos County, New Mexico",9463,574,572,358,439,553,651,379,35,28,35028,1006,1901,2778,1554,952,1762,2720,1706,1958,3663,5498,3260,18625,9463,9162,15929,107,926,528,3346,121324,5279,10885.0,12284.0
1929,"Rio Arriba County, New Mexico",18819,992,1227,802,1565,1276,1363,756,35,39,35039,2791,3278,5136,3363,2704,3271,5462,3943,5495,6549,10598,7306,39159,18819,20340,20775,251,191,10734,27896,39952,5502,14878.0,16511.0
1930,"San Miguel County, New Mexico",13825,641,592,504,721,713,579,601,35,47,35047,2387,2213,3900,2658,2136,2219,3890,3054,4523,4432,7790,5712,27738,13825,13913,16882,365,341,8835,21563,30946,4666,10751.0,11504.0
1931,"Valencia County, New Mexico",38244,2277,2533,1662,2048,2445,2591,1545,35,61,35061,5992,6836,9887,6130,5485,6475,10242,6952,11477,13311,20129,13082,76027,38244,37783,63117,1059,707,5358,46056,48945,13890,27592.0,31939.0
1932,"Torrance County, New Mexico",8251,354,453,445,439,424,494,186,35,57,35057,1294,1477,2157,1590,887,1154,2154,1530,2181,2631,4311,3120,15519,8251,7268,14122,121,23,981,6687,36120,2904,6324.0,7281.0
1933,"Bernalillo County, New Mexico",332204,19920,20755,13110,18805,19748,21938,12708,35,1,35001,57824,68716,82032,47272,55739,67982,89078,59656,113563,136698,171110,106928,677858,332204,345654,503337,20127,17885,74070,338856,53329,136847,274662.0,315332.0
1934,"Otero County, New Mexico",34214,2318,2452,1198,2158,2085,2067,1177,35,35,35035,7290,6192,7430,5343,4936,5819,7776,5905,12226,12011,15206,11248,66137,34214,31923,52309,2343,858,3709,25315,41988,8680,20060.0,23569.0
1935,"Cibola County, New Mexico",13612,906,959,457,870,834,929,655,35,6,35006,2338,2999,3315,1878,2040,2294,3338,2319,4378,5293,6653,4197,26891,13612,13279,12932,297,40,1583,10316,39413,3434,8063.0,8839.0
1936,"De Baca County, New Mexico",1043,44,91,146,90,41,143,36,35,11,35011,110,130,202,214,120,223,157,187,230,353,359,401,2040,1043,997,1364,32,7,457,1091,31625,264,910.0,899.0
1937,"Guadalupe County, New Mexico",2556,211,118,71,75,118,88,41,35,19,35019,302,663,599,483,190,307,512,466,492,970,1111,949,4353,2556,1797,3395,34,9,530,3217,24798,804,1827.0,2179.0
1938,"Catron County, New Mexico",1944,28,24,115,74,82,60,47,35,3,35003,182,252,434,799,51,188,573,507,233,440,1007,1306,3526,1944,1582,3451,0,0,73,671,41910,777,2049.0,2325.0
1939,"Bronx County, New York",676437,53200,50370,29583,51686,47127,48562,28355,36,5,36005,133997,134447,154910,70409,135446,153063,185140,109252,269443,287510,340050,179661,1435068,676437,758631,315533,504814,52989,494363,804018,40088,190057,399522.0,329638.0
1940,"Onondaga County, New York",223287,13493,14047,9033,12874,13128,13666,8801,36,67,36067,38962,39948,60522,33241,40507,41867,65150,43592,79469,81815,125672,76833,462872,223287,239585,368328,52912,17041,4990,22734,61359,97351,208440.0,176798.0
1941,"Clinton County, New York",41257,2002,1950,1294,1916,1961,2101,1178,36,19,36019,8528,7939,11353,6065,7581,6399,11037,7153,16109,14338,22390,13218,80583,41257,39326,73237,3447,1133,1407,2344,56365,17603,32105.0,27471.0
1942,"Seneca County, New York",17957,991,917,649,850,830,1026,600,36,99,36099,3017,3463,4963,2941,2227,2703,4725,3472,5244,6166,9688,6413,34390,17957,16433,31355,1744,285,312,1199,54545,7635,13980.0,12954.0
1943,"Putnam County, New York",49221,2164,2416,2079,2229,2315,3214,2077,36,79,36079,7314,8558,15797,7519,6338,8426,15982,8985,13652,16984,31779,16504,98787,49221,49566,85846,3030,2039,5590,14787,104486,24992,48563.0,43661.0
1944,"Herkimer County, New York",30721,1691,1856,1204,1474,1687,1965,1137,36,43,36043,4590,5034,8809,5681,4308,4966,8997,6802,8898,10000,17806,12483,62057,30721,31336,59365,836,373,272,1340,54646,13436,26255.0,24766.0
1945,"Ontario County, New York",53619,2713,2944,2222,2723,3099,3113,1974,36,69,36069,8255,8792,15688,9474,7734,9147,16369,11733,15989,17939,32057,21207,109511,53619,55892,101371,2769,1501,1582,5195,64944,24959,52258.0,47830.0
1946,"Steuben County, New York",48131,2769,3033,1982,2565,2773,2895,1853,36,101,36101,6601,8518,13805,8387,6377,8197,13767,9864,12978,16715,27572,18251,96422,48131,48291,91286,1623,1480,462,1588,53663,22174,42002.0,38797.0
1947,"Hamilton County, New York",2264,68,73,69,77,94,70,65,36,41,36041,215,284,765,681,217,288,755,685,432,572,1520,1366,4515,2264,2251,4394,36,3,13,75,58675,767,3225.0,2825.0
1948,"Chautauqua County, New York",63355,3485,3321,2479,3518,3433,3692,2339,36,13,36013,10596,10409,17782,11230,9740,10468,18024,13927,20336,20877,35806,25157,128496,63355,65141,118515,3338,723,2843,9608,46820,27046,54234.0,48428.0
1949,"Kings County, New York",1227099,98109,81177,44834,92850,78245,75969,43510,36,47,36047,222863,283792,272756,143616,236945,304844,321834,208678,459808,588636,594590,352294,2589974,1227099,1362875,1132426,833683,307081,225162,493232,60231,550624,805605.0,693937.0
1950,"Tioga County, New York",24144,1233,1343,996,1241,1239,1570,970,36,107,36107,3234,4050,7177,4432,3004,3998,7348,5172,6238,8048,14525,9604,48686,24144,24542,46870,327,374,256,948,62999,10885,22299.0,20555.0
1951,"Orleans County, New York",20443,1110,1119,853,953,1068,1092,780,36,73,36073,3371,3572,6111,3228,2879,3604,6215,3870,6250,7176,12326,7098,40904,20443,20461,36345,2383,250,797,2012,52620,8256,16380.0,15625.0
1952,"Saratoga County, New York",113004,5981,6752,4427,5723,6420,6306,4316,36,91,36091,16808,21225,33119,18128,15338,21091,34241,22063,32146,42316,67360,40191,228502,113004,115498,211792,3992,6697,1195,7337,84291,56453,114094.0,107583.0
1953,"Columbia County, New York",30178,1162,1420,1287,1395,1426,1295,961,36,21,36021,3999,4712,9372,6521,3578,4846,9277,7415,7577,9558,18649,13936,60371,30178,30193,53725,2741,1084,1129,2879,66787,14944,30902.0,27537.0
1954,"Lewis County, New York",13307,797,824,519,891,731,900,542,36,49,36049,1874,2241,3886,2243,1748,2186,3755,2512,3622,4427,7641,4755,26572,13307,13265,25725,185,141,171,461,54524,6401,11325.0,10878.0
1955,"Westchester County, New York",469169,28170,29928,20646,26381,27309,31346,19055,36,119,36119,70024,88694,130805,68636,69785,91077,141193,93575,139809,179771,271998,162211,968890,469169,499721,622855,144053,58140,110029,239034,96610,245744,420655.0,625318.0
1956,"Delaware County, New York",22703,872,1123,798,880,942,1165,751,36,25,36025,3693,3181,6681,5200,3074,3223,6669,5588,6767,6404,13350,10788,44995,22703,22292,42629,802,349,337,1744,49544,10558,19792.0,18763.0
1957,"Montgomery County, New York",24255,1543,1692,1126,1564,1489,1531,911,36,57,36057,3498,4332,6585,4029,3354,4438,6769,4991,6852,8770,13354,9020,49302,24255,25047,42970,1091,362,3419,6950,49462,9343,19054.0,17615.0
1958,"Richmond County, New York",230060,13905,15659,9553,13369,13231,15180,9021,36,85,36085,37135,44191,62862,32435,36215,45972,68838,43007,73350,90163,131700,75442,474893,230060,244833,352034,48958,44246,17548,87576,82783,111346,180960.0,178751.0
1959,"St. Lawrence County, New York",55356,2967,3117,1893,2704,2901,3246,1956,36,89,36089,11632,9351,14549,8458,9981,8542,14287,9940,21613,17893,28836,18398,108913,55356,53557,101115,2654,1100,1094,2565,50940,22693,39158.0,35519.0
1960,"Tompkins County, New York",50677,2236,2036,1569,1885,2015,2064,1228,36,109,36109,17480,8040,10628,6453,17066,8414,11451,7842,34546,16454,22079,14295,102642,50677,51965,82359,3859,9964,1666,5294,60240,23944,42678.0,30851.0
1961,"Warren County, New York",31642,1398,1656,1228,1383,1483,1730,1052,36,113,36113,4482,5171,9433,6396,4142,5259,10094,7491,8624,10430,19527,13887,64276,31642,32634,61452,828,641,188,1646,61024,15474,31408.0,27625.0
1962,"Cortland County, New York",23443,1253,1328,876,1123,1346,1114,778,36,23,36023,5365,3741,6065,3466,6245,3577,6037,4202,11610,7318,12102,7668,47865,23443,24422,45302,928,364,236,1293,56023,9867,20244.0,16700.0
1963,"Dutchess County, New York",146061,6896,7194,5800,6641,6972,8356,5530,36,27,36027,25575,25789,43620,22380,24181,24452,43765,27796,49756,50241,87385,50176,293754,146061,147693,229746,30970,10413,11222,35812,81219,65919,130934.0,119539.0
1964,"Platte County, Wyoming",4531,219,204,232,189,137,275,58,56,31,56031,657,674,1306,1001,364,716,1264,1048,1021,1390,2570,2049,8582,4531,4051,8258,1,100,11,698,50903,2052,4529.0,4923.0
1965,"Sheridan County, Wyoming",15015,768,882,596,745,736,1127,589,56,33,56033,2056,2849,3903,2968,1939,2660,4130,3199,3995,5509,8033,6167,30140,15015,15125,28678,116,203,118,1272,60807,6010,14510.0,16428.0
1966,"Big Horn County, Wyoming",6071,384,329,318,354,344,479,263,56,3,56003,755,994,1510,1238,618,976,1514,1263,1373,1970,3024,2501,11882,6071,5811,11028,52,58,454,1066,52804,2251,5317.0,5752.0
1967,"Crook County, Wyoming",3745,241,295,135,277,211,336,132,56,11,56011,426,651,1060,724,397,532,1136,706,823,1183,2196,1430,7472,3745,3727,7142,10,51,8,105,65132,1429,3826.0,4119.0
1968,"Park County, Wyoming",14347,810,715,593,742,732,985,475,56,29,56029,1887,2400,3880,3099,2043,2472,3992,3360,3930,4872,7872,6459,29148,14347,14801,27618,198,155,291,1586,63582,6429,15095.0,16699.0
1969,"Albany County, Wyoming",19931,914,1159,418,882,665,934,487,56,1,56001,7887,3372,3355,2081,6823,2956,3468,2244,14710,6328,6823,4325,38390,19931,18459,34368,656,1301,535,3658,49322,7649,17060.0,18612.0
1970,"Carbon County, Wyoming",8179,624,484,263,381,626,360,315,56,7,56007,1274,1657,2123,1243,975,1295,1870,1246,2249,2952,3993,2489,15247,8179,7068,13919,163,165,371,2778,60161,3457,6374.0,6662.0
1971,"Goshen County, Wyoming",6789,352,215,213,475,222,521,233,56,15,56015,1069,1222,1869,1369,901,978,1714,1509,1970,2200,3583,2878,13342,6789,6553,12392,52,113,313,1413,54289,2664,5796.0,6241.0
1972,"Uinta County, Wyoming",10406,783,977,521,715,913,775,458,56,41,56041,1323,2034,2612,1325,1354,1981,2537,1340,2677,4015,5149,2665,20479,10406,10073,19132,23,32,420,1870,63403,3206,8470.0,9400.0
1973,"Washakie County, Wyoming",4065,254,201,248,207,314,249,211,56,43,56043,493,707,1068,800,390,692,1006,893,883,1399,2074,1693,8027,4065,3962,7204,3,0,440,1142,54158,1484,3814.0,4012.0
1974,"Hot Springs County, Wyoming",2312,162,125,87,128,127,80,48,56,17,56017,242,380,630,531,289,395,655,573,531,775,1285,1104,4607,2312,2295,4418,0,0,21,175,51413,1010,2586.0,2577.0
1975,"Fremont County, Wyoming",20034,1431,1358,820,1331,1342,1450,735,56,13,56013,2880,3487,5099,3369,2608,3431,5140,3741,5488,6918,10239,7110,39812,20034,19778,28893,214,181,704,2758,55896,6775,17023.0,18111.0
1976,"Sublette County, Wyoming",5478,331,270,272,252,346,286,155,56,35,56035,636,1078,1538,933,478,966,1094,825,1114,2044,2632,1758,9880,5478,4402,9505,0,7,0,721,77403,2000,4390.0,4970.0
1977,"Weston County, Wyoming",3719,194,314,146,199,276,145,95,56,45,56045,503,705,1083,661,358,603,945,709,861,1308,2028,1370,7049,3719,3330,6867,16,54,0,76,57031,1649,3526.0,3542.0
1978,"Aibonito Municipio, Puerto Rico",11030,542,752,431,506,504,751,416,72,9,72009,1812,1880,3081,1999,1775,2002,3432,2572,3587,3882,6513,4571,22988,11030,11958,17250,3444,19,2084,22904,20521,4415,,
1979,"Juncos Municipio, Puerto Rico",18449,931,1236,822,881,1098,1334,800,72,77,72077,3262,3829,4392,2755,3394,4376,5167,3281,6656,8205,9559,6036,38780,18449,20331,19060,5232,87,12400,38519,19605,5742,,
1980,"Lajas Municipio, Puerto Rico",11106,471,650,442,417,635,537,402,72,79,72079,1872,1853,2841,2390,1662,1893,3205,2978,3534,3746,6046,5368,22835,11106,11729,5643,178,0,16844,22552,13992,2661,,
1981,"Adjuntas Municipio, Puerto Rico",8912,596,449,366,207,417,667,352,72,1,72001,1431,1492,2373,1565,1365,1668,2534,1769,2796,3160,4907,3334,17891,8912,8979,13128,182,2,4302,17830,14012,3065,,
1982,"Camuy Municipio, Puerto Rico",15109,644,655,622,673,897,848,594,72,27,72027,2599,2774,3988,2752,2583,2952,4627,3315,5182,5726,8615,6067,31598,15109,16489,27201,561,0,3624,31249,17000,5646,,
1983,"Naguabo Municipio, Puerto Rico",12199,580,916,554,578,1008,768,548,72,103,72103,2078,2346,2791,2071,2285,2962,3258,2469,4363,5308,6049,4540,26075,12199,13876,18094,954,93,6459,25875,19432,5145,,
1984,"Naranjito Municipio, Puerto Rico",13801,699,766,553,683,681,922,529,72,105,72105,2418,2484,3655,2377,2318,2509,3866,2803,4736,4993,7521,5180,28112,13801,14311,23888,2099,0,357,28105,18883,4474,,
1985,"Arecibo Municipio, Puerto Rico",40820,1875,1716,1758,1770,2175,2264,1589,72,13,72013,7205,7196,10423,7698,6715,7909,11886,10262,13920,15105,22309,17960,85390,40820,44570,66905,3896,701,12664,84707,18647,17272,,
1986,"Arroyo Municipio, Puerto Rico",8324,499,490,376,297,397,783,367,72,15,72015,1316,1517,1967,1482,1460,1895,2427,1855,2776,3412,4394,3337,17805,8324,9481,11406,3488,0,2600,17778,17570,2925,,
1987,"Quebradillas Municipio, Puerto Rico",11383,501,524,468,517,461,873,460,72,115,72115,1929,2082,2931,2086,1854,2253,3296,2532,3783,4335,6227,4618,23629,11383,12246,20429,988,39,1975,23255,17473,4500,,
1988,"Guayama Municipio, Puerto Rico",20284,906,1505,917,850,926,1503,819,72,57,72057,4201,3844,4787,3165,3194,3922,5422,3969,7395,7766,10209,7134,40889,20284,20605,29882,5760,60,4186,40469,17261,8612,,
1989,"Culebra Municipio, Puerto Rico",668,31,55,24,19,36,42,17,72,49,72049,82,120,171,154,128,113,136,152,210,233,307,306,1311,668,643,710,77,26,429,1198,23333,182,,
1990,"Gurabo Municipio, Puerto Rico",22145,953,1194,974,912,1296,1591,1000,72,63,72063,3720,4658,5672,3242,4016,5305,6673,3972,7736,9963,12345,7214,46910,22145,24765,30705,6443,67,8968,45436,35018,9479,,
1991,"Barceloneta Municipio, Puerto Rico",11413,586,550,504,564,543,809,480,72,17,72017,1947,2213,2704,2039,2111,2566,3077,2516,4058,4779,5781,4555,24079,11413,12666,19688,860,144,3167,23959,17154,5079,,
1992,"Yauco Municipio, Puerto Rico",16959,758,793,678,714,1129,753,641,72,153,72153,2602,2967,4572,3303,2593,3203,5207,4229,5195,6170,9779,7532,35428,16959,18469,26607,1346,6,6991,35203,14743,7470,,
1993,"Aguadilla Municipio, Puerto Rico",25582,1132,1352,1139,1086,1141,1722,990,72,5,72005,4311,4555,6267,5034,3978,4963,7341,6000,8289,9518,13608,11034,52803,25582,27221,42137,1581,132,8076,51527,16269,10080,,
1994,"Cabo Rojo Municipio, Puerto Rico",22960,881,1091,925,891,1385,1251,916,72,23,72023,3595,4048,5980,4824,3756,4580,6662,6086,7351,8628,12642,10910,48487,22960,25527,11020,785,46,36047,48301,16708,9676,,
1995,"Patillas Municipio, Puerto Rico",8245,349,414,307,326,420,486,306,72,109,72109,1335,1315,2358,1612,1258,1401,2524,1963,2593,2716,4882,3575,16929,8245,8684,2346,14307,0,256,16896,16007,2059,,
1996,"Villalba Municipio, Puerto Rico",10856,603,752,535,545,665,667,473,72,149,72149,1977,1762,2917,1694,1934,1996,3216,2051,3911,3758,6133,3745,22403,10856,11547,12713,773,0,2589,22346,19877,4118,,
1997,"Carolina Municipio, Puerto Rico",70331,3188,3819,2997,3202,3640,4414,2940,72,31,72031,12404,12919,17254,13364,12915,14825,21581,19931,25319,27744,38835,33295,153779,70331,83448,82892,31571,401,24822,151965,29059,33885,,
1998,"Cayey Municipio, Puerto Rico",21008,911,1172,889,897,1350,1049,864,72,35,72035,3523,3681,5621,4024,3582,4139,6209,4687,7105,7820,11830,8711,43785,21008,22777,27571,2860,89,2026,43521,22518,8055,,
1999,"Humacao Municipio, Puerto Rico",24767,1175,1341,1060,1114,1251,1583,992,72,69,72069,3887,4463,6404,4916,4118,4914,7590,6178,8005,9377,13994,11094,52507,24767,27740,28090,11307,299,12119,51960,20434,9318,,
2000,"Morovis Municipio, Puerto Rico",15360,730,827,667,684,558,1312,644,72,101,72101,2724,2843,4112,2315,2759,3014,4197,2434,5483,5857,8309,4749,30962,15360,15602,27244,628,0,1792,30833,20941,5398,,
2001,"Trujillo Alto Municipio, Puerto Rico",31164,1407,1792,1389,1284,1553,2211,1258,72,139,72139,5417,5973,7833,5070,5449,6822,9529,7068,10866,12795,17362,12138,66338,31164,35174,52693,6670,81,3726,65772,32545,15998,,
2002,"Manatí Municipio, Puerto Rico",18281,908,998,804,880,1017,1132,745,72,91,72091,2989,3159,4639,3465,3177,3626,5384,4594,6166,6785,10023,8059,38836,18281,20555,32326,1657,132,4317,37985,18502,8154,,
2003,"Peñuelas Municipio, Puerto Rico",9881,585,662,435,532,718,640,441,72,111,72111,1678,1755,2571,1536,1764,1887,2804,1716,3442,3642,5375,3252,20383,9881,10502,14556,748,47,4931,20281,16718,3840,,
2004,"Rincón Municipio, Puerto Rico",6783,273,324,255,264,390,302,236,72,117,72117,861,1210,1928,1519,960,1278,1993,1850,1821,2488,3921,3369,14056,6783,7273,12075,53,0,576,12417,19907,2773,,
2005,"San Germán Municipio, Puerto Rico",15281,741,940,633,661,927,696,572,72,125,72125,2615,2425,3754,3349,2538,2545,4095,4127,5153,4970,7849,7476,31442,15281,16161,18046,486,0,12717,31269,16486,5468,,
2006,"San Sebastián Municipio, Puerto Rico",18024,803,1192,718,740,741,1333,669,72,131,72131,2742,3174,4535,3892,2615,3332,5223,4443,5357,6506,9758,8335,37120,18024,19096,24289,1350,110,10758,35846,15331,6555,,
2007,"Monroe County, New York",358722,21076,21616,14229,20210,20475,22153,13583,36,55,36055,64999,64795,95260,54157,64432,68844,103735,71187,129431,133639,198995,125344,743341,358722,384619,564617,113808,27115,12865,65176,60075,158472,347790.0,276241.0
2008,"Oneida County, New York",114666,6710,7402,4376,6306,6460,6979,4093,36,65,36065,19294,20373,31393,18519,17356,19002,31341,23756,36650,39375,62734,42275,229959,114666,115293,196219,13771,9304,3263,13276,56027,46172,91009.0,84099.0
2009,"Ulster County, New York",88488,3953,4506,3025,3903,4269,4777,2942,36,111,36111,14385,16169,26474,15426,13718,15062,26678,18828,28103,31231,53152,34254,178665,88488,90177,151001,10780,3396,5515,18237,64304,41768,81355.0,77667.0
2010,"Chemung County, New York",42056,2522,2631,1600,2416,2418,2643,1629,36,15,36015,6434,7900,11598,6903,5841,7263,11918,8711,12275,15163,23516,15614,84895,42056,42839,74766,5324,1135,610,2619,54940,18097,36119.0,31646.0
2011,"Livingston County, New York",31998,1434,1595,1137,1305,1404,1760,1055,36,51,36051,6420,5500,9186,5026,6545,4702,8919,5903,12965,10202,18105,10929,63591,31998,31593,58916,1813,830,791,2328,59510,13217,30031.0,26333.0
2012,"Otsego County, New York",28923,1337,1272,901,1202,1224,1396,923,36,77,36077,6230,4265,7768,5702,7082,4210,8381,6631,13312,8475,16149,12333,59972,28923,31049,56036,1303,814,430,2211,54028,13249,25668.0,22340.0
2013,"Greene County, New York",24796,1095,941,792,924,991,1148,703,36,39,36039,4201,4309,7286,4857,2910,3590,6957,5405,7111,7899,14243,10262,47424,24796,22628,42486,2758,497,481,2804,53601,10659,22050.0,20882.0
2014,"Albany County, New York",148624,8027,7571,5123,7553,7351,7834,5127,36,1,36001,32457,27090,38419,21623,33305,27513,40593,29068,65762,54603,79012,50691,306968,148624,158344,231246,38035,20192,4085,18325,66252,68313,139830.0,121529.0
2015,"Allegany County, New York",23678,1288,1289,880,1120,1290,1302,827,36,3,36003,5152,3434,6094,4096,4443,3498,6030,4500,9595,6932,12124,8596,46688,23678,23010,44565,700,548,216,761,48412,9360,18692.0,17271.0
2016,"Cattaraugus County, New York",38322,2312,2377,1617,2087,2296,2555,1416,36,9,36009,5727,6271,10851,6643,5523,6244,10894,7784,11250,12515,21745,14427,77121,38322,38799,70859,1116,610,470,1620,48703,16142,31161.0,30051.0
2017,"Madison County, New York",35171,1767,2236,1316,1594,1888,1915,1385,36,53,36053,6543,5565,10276,5754,6572,5542,10342,6796,13115,11107,20618,12550,71205,35171,36034,67360,1268,638,309,1572,61633,15518,30064.0,27698.0
2018,"Schenectady County, New York",75505,4668,4923,2965,4387,4609,4355,2896,36,93,36093,12382,14367,20306,11223,12031,14680,21564,14832,24413,29047,41870,26055,154859,75505,79354,118130,15590,7228,6079,10932,65499,31152,67280.0,60591.0
2019,"Genesee County, New York",28941,1481,1513,1079,1486,1857,1459,1031,36,37,36037,4509,5146,8597,4765,4024,4697,8485,5828,8533,9843,17082,10593,57808,28941,28867,53142,1214,455,971,1906,60524,12721,26432.0,25004.0
2020,"Yates County, New York",11952,743,712,522,753,765,846,464,36,123,36123,1909,1767,3202,2347,2276,1824,3448,2683,4185,3591,6650,5030,25011,11952,13059,24122,254,163,111,556,56563,5438,10066.0,8817.0
2021,"Greene County, North Carolina",11674,628,616,490,423,631,572,275,37,79,37079,2019,2734,3061,1448,1241,1643,2706,1868,3260,4377,5767,3316,21033,11674,9359,12519,7334,17,379,3173,39837,2648,8095.0,8715.0
2022,"Mitchell County, North Carolina",7476,371,363,311,335,305,419,241,37,121,37121,986,1233,2055,1692,937,1151,2174,1966,1923,2384,4229,3658,15004,7476,7528,14474,57,27,62,837,46103,2894,8096.0,8960.0
2023,"Chowan County, North Carolina",6575,234,309,293,405,219,489,414,37,41,37041,745,1264,1711,1470,811,1159,2080,1945,1556,2423,3791,3415,14097,6575,7522,8615,4967,46,280,520,46519,2187,7228.0,7754.0
2024,"Alleghany County, North Carolina",5404,235,278,159,221,217,374,193,37,5,37005,654,890,1589,1358,531,822,1687,1559,1185,1712,3276,2917,11008,5404,5604,10501,267,50,89,1066,37830,2048,5315.0,6040.0
2025,"Caldwell County, North Carolina",40432,2088,2103,1588,2027,2454,2054,1684,37,27,37027,5647,6939,12258,7117,5357,6687,12474,8715,11004,13626,24732,15832,81884,40432,41452,72802,3779,415,2912,4488,44511,13892,36320.0,42438.0
2026,"Catawba County, North Carolina",77099,4480,4540,3426,4409,4717,5071,3022,37,35,37035,11502,13730,21697,12139,11414,14060,22425,15396,22916,27790,44122,27535,157613,77099,80514,124641,12896,6855,9206,15257,52056,27948,72351.0,82751.0
2027,"Cleveland County, North Carolina",47012,2873,2965,2005,2558,2939,3036,1886,37,45,37045,7489,7639,13206,7685,7566,8197,14081,10007,15055,15836,27287,17692,97282,47012,50270,72575,20386,1006,1802,3423,42247,15628,44673.0,51095.0
2028,"Craven County, North Carolina",51769,3387,3330,1678,3140,2934,3270,1780,37,49,37049,12165,8818,10962,8611,8206,8467,12359,10566,20371,17285,23321,19177,102491,51769,50722,72130,22169,2823,2053,7469,52687,15799,47001.0,52675.0
2029,"Edgecombe County, North Carolina",24421,1558,1246,1041,1500,1730,1559,1058,37,65,37065,3655,3934,6525,4142,4004,4607,7926,5843,7659,8541,14451,9985,52648,24421,28227,20721,30332,113,543,2415,36866,6373,24886.0,25344.0
2030,"Granville County, North Carolina",30241,1494,1822,1181,1446,1465,1866,1153,37,77,37077,4767,5683,9036,4384,3763,5136,8784,5474,8530,10819,17820,9858,59328,30241,29087,36216,17842,312,2058,4715,55856,9775,27353.0,31316.0
2031,"Harnett County, North Carolina",65571,5104,5002,2728,4748,4821,4803,2624,37,85,37085,11024,14569,15118,6955,10943,14094,15545,9134,21967,28663,30663,16089,132283,65571,66712,88760,27536,1490,7982,16889,53554,21003,46065.0,57733.0
2032,"Hoke County, North Carolina",26783,2404,1877,1119,2266,2149,1764,1030,37,93,37093,4715,6340,5700,2326,4618,6154,6326,2867,9333,12494,12026,5193,53957,26783,27174,23935,18259,816,3864,7198,48072,7037,18230.0,21879.0
2033,"Henderson County, North Carolina",55243,2823,3186,2101,2783,3359,2771,1833,37,89,37089,6562,9265,15115,12986,6479,9670,16529,16246,13041,18935,31644,29232,114913,55243,59670,104809,4002,1537,2268,11575,55945,23895,58176.0,67773.0
2034,"Hyde County, North Carolina",2745,103,153,133,150,153,113,115,37,95,37095,407,685,609,484,209,440,760,528,616,1125,1369,1012,5213,2745,2468,3468,1550,0,137,539,39663,566,2304.0,2470.0
2035,"Iredell County, North Carolina",86425,4974,5466,3913,4719,5135,6249,3811,37,97,37097,12811,16000,24668,12199,11983,16483,25632,15101,24794,32483,50300,27300,175538,86425,89113,142604,21339,4394,2755,13386,60955,34071,82567.0,101276.0
2036,"Mecklenburg County, North Carolina",516517,36948,36463,20831,35276,35208,35126,20818,37,119,37119,93144,119691,124743,49109,97557,127704,138086,68183,190701,247395,262829,117292,1074475,516517,557958,577943,339021,62922,60010,142472,66641,241665,472857.0,563218.0
2037,"Northampton County, North Carolina",9699,438,519,302,425,469,475,316,37,131,37131,1387,1460,2843,2157,1213,1362,3144,2843,2600,2822,5987,5000,19946,9699,10247,7900,11246,56,122,453,37146,2847,9848.0,10075.0
2038,"Pitt County, North Carolina",83978,5291,5289,3255,5086,5373,5051,3138,37,147,37147,21027,14953,18538,9695,24226,16923,21494,13164,45253,31876,40032,22859,178433,83978,94455,102087,61924,3116,5947,11168,47437,28952,80527.0,86217.0
2039,"Rowan County, North Carolina",69468,4055,4213,2987,3881,4358,4275,2687,37,159,37159,10840,12295,19317,10777,10361,12414,19507,13345,21201,24709,38824,24122,140296,69468,70828,107590,22677,1228,4849,12381,49842,23673,64369.0,72756.0
2040,"Vance County, North Carolina",20751,1436,1067,900,1326,1497,1460,990,37,181,37181,3355,3190,5538,3327,3388,3877,6567,4623,6743,7067,12105,7950,44479,20751,23728,18961,22166,319,1286,3466,40529,6259,19977.0,20948.0
2041,"Cherokee County, North Carolina",13716,596,449,447,483,734,583,450,37,39,37039,1545,2016,3857,3803,1447,1973,4289,4294,2992,3989,8146,8097,27969,13716,14253,26095,348,203,270,881,41438,6051,14181.0,16341.0
2042,"Currituck County, North Carolina",13103,769,914,531,657,912,744,535,37,53,37053,1562,2512,4091,1949,1606,2507,4071,2228,3168,5019,8162,4177,26363,13103,13260,23822,1461,114,249,1048,69964,5132,12669.0,16006.0
2043,"Union County, North Carolina",113824,6767,8283,6390,6545,8442,9752,6066,37,179,37179,15829,20758,32395,12679,15562,22692,32347,15823,31391,43450,64742,28502,231053,113824,117229,187754,26454,6989,3909,25731,80033,45491,105710.0,129475.0
2044,"Wilkes County, North Carolina",33733,1620,1951,1501,1806,1939,1995,1136,37,193,37193,4516,5744,9897,6358,4362,5618,9870,8010,8878,11362,19767,14368,68469,33733,34736,62347,2712,398,1381,4475,44107,11586,31296.0,35197.0
2045,"Nash County, North Carolina",45074,2693,2810,1977,2548,3030,2744,1913,37,127,37127,7023,7534,12699,7171,7007,8279,13879,9556,14030,15813,26578,16727,94030,45074,48956,48968,36961,820,3844,6569,49537,14430,47665.0,51826.0
2046,"Alexander County, North Carolina",18940,895,922,620,974,941,1139,774,37,3,37003,2813,3612,5499,3276,2187,3106,5180,3972,5000,6718,10679,7248,37213,18940,18273,32622,2173,389,1382,1743,48756,7043,18271.0,20120.0
2047,"Dare County, North Carolina",18110,884,1080,665,684,939,1013,559,37,55,37055,2126,3089,5539,3570,1915,3276,5797,3929,4041,6365,11336,7499,36222,18110,18112,33591,1086,279,450,2714,59381,8445,19609.0,24061.0
2048,"Warren County, North Carolina",9884,444,477,342,455,523,469,344,37,185,37185,1398,1636,2819,2178,1196,1451,2866,2710,2594,3087,5685,4888,19898,9884,10014,7900,10004,104,281,750,36466,2692,9842.0,10207.0
2049,"Wilson County, North Carolina",38537,2474,2670,1656,2340,2389,2840,1662,37,195,37195,6053,6478,10379,6026,6161,7559,11744,8203,12214,14037,22123,14229,81435,38537,42898,41323,32275,675,4607,8430,43877,11694,38135.0,40446.0
2050,"Gates County, North Carolina",5641,235,347,165,226,366,362,240,37,73,37073,772,752,1899,1051,690,944,1847,1232,1462,1696,3746,2283,11548,5641,5907,7314,3859,61,2,11,50750,1828,5392.0,5944.0
2051,"Graham County, North Carolina",4136,174,281,162,205,202,300,155,37,75,37075,561,634,1154,900,504,707,1229,1071,1065,1341,2383,1971,8509,4136,4373,7436,17,0,110,178,39571,1588,4168.0,4606.0
2052,"Madison County, North Carolina",10526,488,632,409,514,442,530,433,37,115,37115,1778,1782,2841,2120,1645,1780,3066,2563,3423,3562,5907,4683,21499,10526,10973,20504,349,125,100,523,45873,4789,11269.0,13000.0
2053,"Pamlico County, North Carolina",6464,224,273,172,189,215,282,251,37,137,37137,799,1119,1771,1783,619,866,1898,1917,1418,1985,3669,3700,12701,6464,6237,9664,2341,77,168,493,46728,2401,6870.0,7572.0
2054,"Polk County, North Carolina",9719,330,389,352,351,584,449,347,37,149,37149,1109,1438,2768,2761,1060,1291,3314,3442,2169,2729,6082,6203,20557,9719,10838,18556,1005,136,617,1204,48787,4283,10934.0,12253.0
2055,"Randolph County, North Carolina",70546,4076,4513,3138,3978,4338,4592,3083,37,151,37151,10266,12258,20171,11151,9871,12552,20467,13691,20137,24810,40638,24842,143118,70546,72572,119970,8619,1737,8902,16361,47288,24275,64575.0,72788.0
2056,"Stokes County, North Carolina",22256,1012,1350,890,956,1073,1564,890,37,169,37169,2919,3589,7301,4116,2934,3895,7030,5183,5853,7484,14331,9299,45781,22256,23525,42590,1909,167,292,1400,48054,8926,22550.0,25525.0
2057,"Washington County, North Carolina",5591,367,356,149,184,381,312,255,37,187,37187,838,725,1518,1224,903,952,1754,1590,1741,1677,3272,2814,11922,5591,6331,5450,5658,26,230,622,35979,1490,6165.0,6191.0
2058,"Clay County, North Carolina",5213,198,281,112,210,353,363,26,37,43,37043,606,705,1434,1504,615,729,1643,1794,1221,1434,3077,3298,10946,5213,5733,10580,228,22,8,364,42222,2372,6010.0,6828.0
2059,"Cumberland County, North Carolina",165585,12814,11959,6383,12431,11001,10825,6314,37,51,37051,44085,30980,32550,16233,32760,32923,38733,22289,76845,63903,71283,38522,332861,165585,167276,166394,123259,8267,9260,38555,46875,51548,127506.0,145598.0
2060,"Guilford County, North Carolina",249974,16019,16210,10446,15263,15320,17299,10228,37,81,37081,45582,46410,64733,33215,50855,52432,71502,44995,96437,98842,136235,78210,527868,249974,277894,291462,178875,26115,13753,42071,53261,106257,257405.0,281201.0
2061,"Jackson County, North Carolina",20985,1177,927,660,853,936,984,658,37,99,37099,5216,3265,4916,3809,5542,3235,5284,4461,10758,6500,10200,8270,42938,20985,21953,35688,956,315,1021,2552,47252,8333,18713.0,21237.0
2062,"Pasquotank County, North Carolina",19268,1365,1155,665,1249,1343,1046,669,37,139,37139,3343,3705,4915,2801,3161,3627,5434,3717,6504,7332,10349,6518,39514,19268,20246,23087,14449,485,205,2123,50558,7060,17391.0,19512.0
2063,"Robeson County, North Carolina",63995,4591,4942,2873,4356,4555,4690,2774,37,155,37155,11387,11286,15867,8425,11284,12360,17495,11087,22671,23646,33362,19512,132596,63995,68601,37096,31585,798,7451,11774,34976,14253,40858.0,44384.0
2064,"Swain County, North Carolina",6966,526,480,242,388,483,454,269,37,173,37173,1003,1172,1863,1236,1037,1214,1981,1468,2040,2386,3844,2704,14260,6966,7294,9147,67,54,126,757,39317,2102,6124.0,7026.0
2065,"Wake County, North Carolina",519794,34001,36702,22325,32697,35464,37260,21910,37,183,37183,87715,116340,132571,52024,88519,123594,141486,68355,176234,239934,274057,120379,1069079,519794,549285,698759,218151,74284,42070,108379,80591,267128,527624.0,624049.0
2066,"Anson County, North Carolina",13056,586,657,464,586,700,700,427,37,7,37007,2192,2980,3542,1924,1693,1918,3285,2537,3885,4898,6827,4461,24902,13056,11846,11892,12094,331,137,1005,40213,2985,10545.0,11183.0
2067,"McDowell County, North Carolina",22752,1065,1964,757,980,1137,1267,763,37,111,37111,3151,4144,6249,4097,2841,3808,6785,4894,5992,7952,13034,8991,45227,22752,22475,41437,1628,415,976,2766,43646,8637,19875.0,22891.0
2068,"Franklin County, North Carolina",32942,1899,1921,1399,1826,1744,2359,1253,37,69,37069,5072,5993,9514,4829,4375,5977,9807,6079,9447,11970,19321,10908,66362,32942,33420,44679,16594,329,1952,5587,55193,11522,30368.0,37079.0
2069,"Jones County, North Carolina",4750,263,292,160,156,159,229,189,37,103,37103,608,732,1371,959,569,750,1560,1232,1177,1482,2931,2191,9594,4750,4844,6303,2923,8,97,443,38158,1427,5135.0,5484.0
2070,"Macon County, North Carolina",16864,961,694,608,723,774,957,572,37,113,37113,2008,2507,4616,4365,1935,2580,4904,5504,3943,5087,9520,9869,34813,16864,17949,32536,580,302,935,2440,45507,7295,17734.0,20647.0
2071,"Brunswick County, North Carolina",63419,2672,2849,1872,2613,3020,2615,1727,37,19,37019,6727,9104,17639,19297,6588,9748,21159,20926,13315,18852,38798,40223,131815,63419,68396,110980,12864,766,3084,6339,58236,28030,68351.0,89328.0
2072,"Transylvania County, North Carolina",16252,719,692,526,616,943,612,435,37,175,37175,2259,2293,4292,4608,2059,2548,4806,5504,4318,4841,9098,10112,33775,16252,17523,30933,1612,47,608,1124,50212,7569,17869.0,20253.0
2073,"Beaufort County, North Carolina",22529,1242,1285,944,1096,1130,1557,871,37,13,37013,2812,3506,6347,4910,2895,3984,7003,6103,5707,7490,13350,11013,47168,22529,24639,33969,11782,52,405,3658,45212,7410,23938.0,26164.0
2074,"Columbus County, North Carolina",27857,1505,1769,1084,1376,1573,1705,1237,37,47,37047,4588,5109,7402,4688,3735,4636,7701,6248,8323,9745,15103,10936,56068,27857,28211,34778,17089,228,972,2983,37628,8846,23732.0,26243.0
2075,"Lincoln County, North Carolina",41244,2355,2389,1669,1930,2564,2359,1608,37,109,37109,5502,7412,12586,6441,5152,7531,12871,7660,10654,14943,25457,14101,82919,41244,41675,74133,4125,593,2019,6014,57536,16178,40023.0,49850.0
2076,"Montgomery County, North Carolina",13345,702,632,691,970,788,822,474,37,123,37123,2063,1896,3866,2472,1792,2289,3868,2904,3855,4185,7734,5376,27252,13345,13907,20612,4794,393,730,4184,44146,4328,11540.0,12779.0
2077,"Orange County, North Carolina",69204,3391,4424,2695,3213,3631,4374,2549,37,135,37135,16649,12032,17157,8616,19618,12625,18835,10787,36267,24657,35992,19403,144836,69204,75632,109195,16562,11363,2991,12236,71723,37186,82340.0,84010.0
2078,"Richmond County, North Carolina",22048,1320,1462,943,1389,1207,1521,874,37,153,37153,3739,3753,5882,3408,3334,3978,6207,4439,7073,7731,12089,7847,44997,22048,22949,27785,14344,436,474,2914,36148,6989,19328.0,20597.0
2079,"Sampson County, North Carolina",31127,2081,2296,1431,2007,1906,2379,1313,37,163,37163,4559,5597,8299,4721,4395,5542,8392,6324,8954,11139,16691,11045,63385,31127,32258,39791,16080,356,4286,12445,42151,9487,25928.0,28394.0
2080,"Surry County, North Carolina",34908,1867,2091,1551,1814,2265,2192,1455,37,171,37171,5097,5811,9981,6351,4702,6005,10505,8125,9799,11816,20486,14476,71971,34908,37063,65358,2683,415,2171,7632,43597,11903,32196.0,36290.0
2081,"Avery County, North Carolina",9616,289,368,239,301,309,400,272,37,11,37011,1590,2149,2807,1772,1144,1235,2198,2031,2734,3384,5005,3803,17506,9616,7890,16109,693,77,220,886,40340,3484,8249.0,9339.0
2082,"Buncombe County, North Carolina",123240,6645,6544,4381,6158,6342,6849,4072,37,21,37021,18478,25561,32756,21710,19330,26177,36503,28215,37808,51738,69259,49925,256886,123240,133646,228237,16101,3249,2846,16889,52207,63111,138947.0,160443.0
2083,"Cabarrus County, North Carolina",100729,6770,7534,4835,6430,5979,8857,4656,37,25,37025,14532,20684,26464,11661,14324,22469,27943,15228,28856,43153,54407,26889,206615,100729,105886,145738,37166,7700,9597,21570,67328,41274,93289.0,116722.0
2084,"Caswell County, North Carolina",11395,535,502,353,513,589,622,424,37,33,37033,1683,2077,3451,2063,1282,1753,3474,2632,2965,3830,6925,4695,22684,11395,11289,14307,7425,152,438,915,45733,3575,11070.0,11962.0
2085,"Davie County, North Carolina",20485,1039,1309,883,1023,1257,1231,902,37,59,37059,2463,3539,6026,3855,2511,3505,6643,4700,4974,7044,12669,8555,42257,20485,21772,37753,2094,300,759,2875,60434,8864,21756.0,25059.0
2086,"Davidson County, North Carolina",80791,4527,4795,3401,4519,5395,4651,3381,37,57,37057,11236,14037,23696,13114,11117,14754,24404,16369,22353,28791,48100,29483,165381,80791,84590,141830,15232,2586,2201,11754,49546,29696,74856.0,84785.0
2087,"Duplin County, North Carolina",28715,1904,2375,1349,1789,1854,2098,1190,37,61,37061,4146,4991,7555,4635,4038,5168,8170,5945,8184,10159,15725,10580,58967,28715,30252,42010,14006,223,1254,13072,41764,7981,20856.0,22510.0
2088,"Durham County, North Carolina",149039,10514,9377,4922,9958,9325,8093,4979,37,63,37063,29209,35000,34908,16456,31314,36718,39612,22810,60523,71718,74520,39266,311848,149039,162809,161919,113682,15279,10519,42079,60958,81040,156134.0,177227.0
2089,"Hertford County, North Carolina",11901,513,528,481,596,490,789,384,37,91,37091,2384,2064,3189,1960,1920,1776,3463,2693,4304,3840,6652,4653,24012,11901,12111,8422,14263,184,220,921,41028,3056,10186.0,10590.0
2090,"Lee County, North Carolina",29309,2004,2051,1198,1896,1864,2221,1311,37,105,37105,4455,5476,7705,4214,4473,5733,8143,5531,8928,11209,15848,9745,60481,29309,31172,44592,12273,807,1334,11584,49994,9122,25084.0,28851.0
2091,"New Hanover County, North Carolina",108794,5778,5815,3740,5488,5876,5944,3549,37,129,37129,21567,21240,27142,17027,23498,21966,30590,22233,45065,43206,57732,39260,227938,108794,119144,184851,31337,3012,2870,12657,54891,48469,111905.0,129254.0
2092,"Pender County, North Carolina",29972,1803,1754,1240,1595,1893,1982,1167,37,141,37141,3892,5616,8702,4925,3522,5643,8838,5787,7414,11259,17540,10712,60399,29972,30427,46947,8612,263,2562,4263,57240,12030,27885.0,33971.0
2093,"Wayne County, North Carolina",60358,4177,3690,2531,4067,3908,4037,2357,37,191,37191,11181,10670,15077,8387,9815,11170,16510,11381,20996,21840,31587,19768,123603,60358,63245,78721,37666,1488,1386,14525,44416,18262,50689.0,55091.0
2094,"Scotland County, North Carolina",17293,1145,1071,607,1090,1298,966,588,37,165,37165,2917,3278,4400,2594,2753,2972,4601,3515,5670,6250,9001,6109,35076,17293,17783,15317,13660,284,817,1053,37238,4336,13928.0,14632.0
2095,"Watauga County, North Carolina",27313,949,1080,708,894,1020,955,591,37,189,37189,9692,3924,6026,3979,9658,3698,6268,4528,19350,7622,12294,8507,54925,27313,27612,51539,967,651,539,2009,47526,10533,29985.0,31771.0
2096,"Halifax County, North Carolina",24757,1361,1359,968,1406,1534,1347,961,37,83,37083,3681,4114,6861,4338,3570,4065,7587,5963,7251,8179,14448,10301,51190,24757,26433,20721,27013,374,77,1475,35502,6670,25167.0,25485.0
2097,"Alamance County, North Carolina",77542,4869,5429,3285,4639,4200,5783,3227,37,1,37001,12860,13819,20746,11428,14435,14976,22785,15737,27295,28795,43531,27165,163324,77542,85782,113953,31926,2602,10192,20511,49688,27648,71157.0,84710.0
2098,"Tyrrell County, North Carolina",2356,30,83,34,99,108,51,20,37,177,37177,429,490,796,349,206,266,519,470,635,756,1315,819,4095,2356,1739,2268,1521,18,169,284,35300,567,1739.0,1812.0
2099,"Stark County, North Dakota",15927,1247,1235,579,1278,1089,1070,573,38,89,38089,2852,3388,3867,1789,2660,2889,3345,2250,5512,6277,7212,4039,31081,15927,15154,28352,625,387,346,1690,72045,6203,12322.0,15019.0
2100,"Wells County, North Dakota",1980,99,198,44,121,160,86,49,38,103,38103,212,244,613,476,155,288,556,581,367,532,1169,1057,3976,1980,1996,3892,0,9,6,100,57582,831,2383.0,2372.0
2101,"Burke County, North Dakota",1187,133,92,38,82,58,95,15,38,13,38013,151,195,324,172,110,195,243,197,261,390,567,369,2182,1187,995,2099,5,11,16,25,77232,419,1052.0,1332.0
2102,"Mountrail County, North Dakota",5558,458,376,146,445,440,249,272,38,61,38061,1127,1164,1301,583,746,892,1135,584,1873,2056,2436,1167,10321,5558,4763,6648,146,49,252,838,72147,1965,4106.0,4142.0
2103,"Williams County, North Dakota",19250,1695,1537,720,1496,1216,1189,639,38,105,38105,3594,4814,4056,1446,3120,3143,3396,1759,6714,7957,7452,3205,35208,19250,15958,28778,1572,341,1779,2709,87161,5780,12807.0,14285.0
2104,"Billings County, North Dakota",516,61,34,13,30,16,22,8,38,7,38007,37,135,127,96,28,75,126,101,65,210,253,197,922,516,406,895,0,0,16,27,75208,213,605.0,633.0
2105,"Kidder County, North Dakota",1320,74,76,61,84,68,37,50,38,43,38043,188,179,398,266,98,155,395,259,286,334,793,525,2466,1320,1146,2369,5,6,41,89,54643,453,1376.0,1450.0
2106,"Cavalier County, North Dakota",1948,144,78,66,108,100,109,59,38,19,38019,235,256,536,484,194,233,506,546,429,489,1042,1030,3803,1948,1855,3609,2,0,68,68,64798,776,2006.0,2020.0
2107,"Grant County, North Dakota",1204,54,88,48,82,49,79,42,38,37,38037,111,196,312,350,110,152,301,334,221,348,613,684,2353,1204,1149,2271,2,28,0,25,50938,571,1381.0,1367.0
2108,"McHenry County, North Dakota",3004,165,219,129,168,218,180,119,38,49,38049,350,528,851,563,287,485,794,623,637,1013,1645,1186,5878,3004,2874,5700,21,23,13,127,64179,1228,2820.0,2974.0
2109,"Steele County, North Dakota",918,34,28,20,42,41,89,13,38,91,38091,99,119,345,198,119,88,226,208,218,207,571,406,1744,918,826,1708,13,0,6,30,70724,425,999.0,1085.0
2110,"Benson County, North Dakota",3522,383,324,180,353,296,342,155,38,5,38005,523,530,770,457,485,496,767,457,1008,1026,1537,914,6873,3522,3351,2793,3,4,14,64,47667,729,2011.0,1952.0
2111,"LaMoure County, North Dakota",2132,107,139,71,95,116,118,64,38,45,38045,243,288,608,515,255,258,545,542,498,546,1153,1057,4125,2132,1993,3981,41,8,22,80,60806,839,2151.0,2206.0
2112,"Morton County, North Dakota",15564,970,1142,491,957,921,931,474,38,59,38059,2415,3355,4116,2249,2472,3011,3852,2686,4887,6366,7968,4935,30868,15564,15304,28149,310,201,524,1072,70556,6813,15832.0,16603.0
2113,"Dunn County, North Dakota",2301,146,105,81,149,157,132,96,38,25,38025,339,369,710,364,292,337,563,368,631,706,1273,732,4395,2301,2094,3731,75,35,52,111,76719,1036,2243.0,2328.0
2114,"McIntosh County, North Dakota",1311,73,41,52,53,60,61,15,38,51,38051,125,196,391,337,126,165,332,474,251,361,723,811,2597,1311,1286,2492,14,13,45,72,52587,477,1446.0,1447.0
2115,"Nelson County, North Dakota",1465,68,66,46,78,82,60,45,38,63,38063,191,203,425,380,139,186,429,410,330,389,854,790,2894,1465,1429,2794,3,1,58,101,52039,658,1717.0,1774.0
2116,"Rolette County, North Dakota",7188,701,664,372,666,704,712,317,38,79,38079,1122,1188,1614,758,1076,1244,1724,880,2198,2432,3338,1638,14511,7188,7323,2640,93,21,38,80,43158,1707,3755.0,3791.0
2117,"Walsh County, North Dakota",5512,393,375,223,339,374,236,183,38,99,38099,770,791,1608,1023,610,816,1456,1225,1380,1607,3064,2248,10751,5512,5239,10130,44,51,147,1240,55700,1926,4636.0,4762.0
2118,"Bottineau County, North Dakota",3393,195,189,118,167,163,213,96,38,9,38009,530,499,908,715,363,481,851,775,893,980,1759,1490,6502,3393,3109,6048,42,7,33,150,60381,1171,3494.0,3456.0
2119,"Barnes County, North Dakota",5325,266,303,164,238,238,353,191,38,3,38003,898,812,1560,1051,796,799,1475,1291,1694,1611,3035,2342,10706,5325,5381,10046,239,109,16,219,58365,2626,5344.0,5507.0
2120,"Grand Forks County, North Dakota",36394,2491,1912,1036,2299,2137,1641,935,38,35,38035,11327,6443,7178,3874,9546,5338,7178,4756,20873,11781,14356,8630,70224,36394,33830,60439,2641,1962,1190,3011,54051,12292,30365.0,30915.0
2121,"McKenzie County, North Dakota",7266,718,695,337,658,655,409,243,38,53,38053,1345,1526,1596,552,1055,1091,1352,605,2400,2617,2948,1157,13334,7266,6068,11112,216,53,146,1114,77845,2629,4672.0,5412.0
2122,"McLean County, North Dakota",4964,322,328,175,230,308,285,150,38,55,38055,553,815,1421,1083,500,741,1295,1111,1053,1556,2716,2194,9584,4964,4620,8620,66,8,67,237,68529,1947,5315.0,5491.0
2123,"Pierce County, North Dakota",2043,149,129,46,121,155,81,79,38,69,38069,276,318,601,404,258,289,522,578,534,607,1123,982,4126,2043,2083,3869,25,15,3,18,55660,860,2071.0,2378.0
2124,"Renville County, North Dakota",1238,76,86,23,142,93,62,29,38,75,38075,180,245,323,210,129,170,364,215,309,415,687,425,2442,1238,1204,2364,6,5,14,183,73182,512,1293.0,1305.0
2125,"Bowman County, North Dakota",1561,96,137,61,111,152,66,60,38,11,38011,201,270,410,299,210,259,381,348,411,529,791,647,3148,1561,1587,3026,1,0,40,172,62442,663,1787.0,1643.0
2126,"Burleigh County, North Dakota",47528,3335,3208,1683,3136,3096,2855,1582,38,15,38015,8099,10114,11509,6501,7575,8923,11792,8306,15674,19037,23301,14807,94793,47528,47265,85927,2140,734,218,2368,71524,19420,47979.0,50465.0
2127,"Logan County, North Dakota",974,77,68,36,49,41,44,41,38,47,38047,121,127,285,236,62,136,237,288,183,263,522,524,1872,974,898,1833,0,2,2,16,59375,410,1067.0,1066.0
2128,"Oliver County, North Dakota",944,77,36,54,53,75,53,40,38,65,38065,55,132,272,221,83,153,230,211,138,285,502,432,1842,944,898,1671,0,32,0,52,78929,330,1017.0,1063.0
2129,"Stutsman County, North Dakota",10714,602,525,358,593,732,438,328,38,93,38093,1854,2047,2925,1783,1641,1706,2634,2179,3495,3753,5559,3962,20965,10714,10251,19479,309,107,157,524,57674,4565,10155.0,9939.0
2130,"Ramsey County, North Dakota",5908,381,542,215,354,423,274,260,38,71,38071,965,956,1595,1011,836,828,1489,1211,1801,1784,3084,2222,11583,5908,5675,9764,64,99,19,341,58910,2299,5305.0,5362.0
2131,"Foster County, North Dakota",1599,79,82,47,105,68,145,63,38,31,38031,210,263,484,326,198,276,398,408,408,539,882,734,3260,1599,1661,3127,0,1,0,35,61425,686,1719.0,1748.0
2132,"Griggs County, North Dakota",1219,82,68,49,84,38,61,48,38,39,38039,125,160,306,349,104,179,310,366,229,339,616,715,2409,1219,1190,2296,0,0,20,20,53565,543,1265.0,1248.0
2133,"Sheridan County, North Dakota",718,38,34,23,43,34,30,14,38,83,38083,99,99,226,184,46,79,211,234,145,178,437,418,1409,718,691,1393,0,0,0,0,51055,308,787.0,812.0
2134,"Slope County, North Dakota",362,7,25,18,25,28,28,0,38,87,38087,50,56,103,86,28,54,106,111,78,110,209,197,742,362,380,715,13,0,0,0,63611,168,430.0,426.0
2135,"Union County, Ohio",27323,1764,1810,1445,1726,2040,1834,1174,39,159,39159,3868,5561,7652,3027,4138,6877,7823,3772,8006,12438,15475,6799,56707,27323,29384,51608,1470,2269,287,983,86715,13454,27429.0,32838.0
2136,"Pike County, Ohio",13818,804,928,613,820,921,746,661,39,131,39131,2053,2391,3791,2230,1823,2505,4021,2685,3876,4896,7812,4915,28000,13818,14182,26742,468,23,18,126,42832,5435,11879.0,12063.0
2137,"Paulding County, Ohio",9413,561,695,395,523,638,668,365,39,125,39125,1262,1625,2717,1545,1164,1605,2564,1869,2426,3230,5281,3414,18809,9413,9396,17951,147,41,233,896,55330,4385,9047.0,9280.0
2138,"Hamilton County, Ohio",392738,27421,25803,15576,26182,25964,25320,15004,39,61,39061,70794,74944,99531,52040,70293,78867,108810,70411,141087,153811,208341,122451,813589,392738,420851,548299,207839,21550,7818,26867,57212,170454,409109.0,417574.0
2139,"Franklin County, Ohio",629722,46862,43616,23236,45123,40575,39990,22651,39,49,39049,125593,140096,146513,64179,126989,141532,156546,87232,252582,281628,303059,151411,1290360,629722,660638,855170,291177,67795,23200,71292,61305,279644,581140.0,606022.0
2140,"Marion County, Ohio",34643,1906,1856,1349,1909,1839,1795,1169,39,101,39101,5569,7215,9750,5074,4188,5184,8380,6192,9757,12399,18130,11266,65299,34643,30656,58505,3714,420,396,1747,47498,13395,26322.0,27126.0
2141,"Tuscarawas County, Ohio",45476,2939,2812,1929,2828,2779,2861,1870,39,157,39157,6379,8318,12234,7783,6271,7743,12536,9971,12650,16061,24770,17754,92335,45476,46859,89194,661,370,114,2612,53243,20222,41289.0,42820.0
2142,"Wayne County, Ohio",57717,4177,4099,2519,3560,3572,3957,2458,39,169,39169,9425,9794,14749,8981,8936,9561,15208,11130,18361,19355,29957,20111,116099,57717,58382,109717,1584,1211,1206,2335,58300,23960,49853.0,58342.0
2143,"Brown County, Ohio",21681,1248,1223,966,1264,1121,1663,882,39,15,39015,2875,3893,6124,3705,2773,3818,6175,4195,5648,7711,12299,7900,43572,21681,21891,42265,353,124,176,456,54575,9726,19607.0,20586.0
2144,"Butler County, Ohio",186236,11801,12255,8060,11375,11456,13333,7760,39,17,39017,34395,33686,48125,24167,34581,34601,50237,30440,68976,68287,98362,54607,380019,186236,193783,320689,30587,12447,4105,17914,66117,77319,173839.0,182034.0
2145,"Harrison County, Ohio",7489,418,452,322,393,430,480,302,39,67,39067,916,1141,2353,1487,900,1213,2305,1699,1816,2354,4658,3186,15211,7489,7722,14484,434,75,31,60,49689,3310,7079.0,7500.0
2146,"Knox County, Ohio",29878,1824,2215,1257,1821,1843,2025,1262,39,83,39083,5085,4908,7915,4890,5390,5048,8198,6016,10475,9956,16113,10906,61481,29878,31603,59292,607,282,73,923,57749,13500,28687.0,30703.0
2147,"Licking County, Ohio",85151,5324,5361,3659,5166,5429,5589,3502,39,89,39089,12776,15547,23654,12411,12749,15930,24648,15586,25525,31477,48302,27997,173750,85151,88599,158836,6676,2179,778,3337,64589,36796,82761.0,91830.0
2148,"Richland County, Ohio",61468,3498,3426,2370,3428,3298,3908,2228,39,139,39139,10130,11789,16168,9981,7860,9772,15888,13250,17990,21561,32056,23231,121100,61468,59632,104983,10808,959,552,2318,49547,23588,55214.0,58601.0
2149,"Vinton County, Ohio",6597,391,331,271,357,315,497,271,39,163,39163,918,1156,1950,1054,811,1159,1904,1172,1729,2315,3854,2226,13083,6597,6486,12716,34,23,0,90,45673,3001,5502.0,5902.0
2150,"Carroll County, Ohio",13743,713,741,545,651,777,769,555,39,19,39019,1742,2222,4117,2707,1640,2167,4051,2979,3382,4389,8168,5686,27332,13743,13589,27126,72,9,22,359,55267,6864,13074.0,13957.0
2151,"Hancock County, Ohio",37499,2302,2383,1523,2264,2307,2412,1399,39,63,39063,6185,6925,10274,5560,6132,6782,9979,7063,12317,13707,20253,12623,75837,37499,38338,69813,1258,1467,1255,4145,58450,16949,36023.0,37999.0
2152,"Clermont County, Ohio",100551,6070,6595,4262,5867,6835,6577,4104,39,25,39025,14584,19214,28092,14446,14027,18942,29657,17715,28611,38156,57749,32161,204275,100551,103724,194339,2895,2550,425,3964,66968,43865,99121.0,108531.0
2153,"Fairfield County, Ohio",76903,4650,5335,3576,4483,4857,5400,3374,39,45,39045,11815,14367,20999,10610,10179,14827,21285,13149,21994,29194,42284,23759,154457,76903,77554,134573,11384,2492,1107,3398,67609,33608,72913.0,81591.0
2154,"Defiance County, Ohio",19028,1179,1250,877,1042,1008,1360,787,39,39,39039,2933,3386,4950,3162,2670,3512,4970,3783,5603,6898,9920,6945,38160,19028,19132,34608,670,168,1247,3804,59931,7810,18192.0,19032.0
2155,"Highland County, Ohio",21048,1407,1322,992,1248,1395,1429,919,39,71,39071,2955,3651,5663,3462,2920,3716,6080,4261,5875,7367,11743,7723,43016,21048,21968,41178,627,170,100,476,44169,8991,18501.0,19303.0
2156,"Henry County, Ohio",13387,792,956,554,802,909,908,612,39,69,39069,1896,2363,3750,2213,1760,2410,3733,2687,3656,4773,7483,4900,27208,13387,13821,25451,252,85,761,2089,59695,5881,13932.0,14482.0
2157,"Jefferson County, Ohio",32276,1726,1589,1250,1598,1618,1847,1071,39,81,39081,4881,5232,9325,6140,5132,5266,9753,7810,10013,10498,19078,13950,66371,32276,34095,60567,3654,349,145,966,46581,14620,32201.0,32572.0
2158,"Portage County, Ohio",79755,4006,4351,3009,3491,4076,4431,2950,39,133,39133,17609,12951,21542,11907,18778,12744,22362,13924,36387,25695,43904,25831,162511,79755,82756,147306,6724,2907,890,2999,57618,37211,76139.0,81280.0
2159,"Putnam County, Ohio",16944,1122,1317,703,1149,1256,1185,676,39,137,39137,2298,2884,4756,2616,2211,2819,4565,3106,4509,5703,9321,5722,33911,16944,16967,31974,137,53,1290,2103,64822,7469,18767.0,19671.0
2160,"Belmont County, Ohio",34882,1691,1708,1281,1642,1604,1863,1070,39,13,39013,5200,6780,10091,6095,4044,5429,9755,7735,9244,12209,19846,13830,68024,34882,33142,63374,2652,333,307,674,50904,15500,31122.0,32534.0
2161,"Clinton County, Ohio",20750,1296,1536,884,1274,1268,1354,844,39,27,39027,3206,3606,5715,3164,3163,3739,5778,3787,6369,7345,11493,6951,41957,20750,21207,39562,861,200,154,677,52815,8545,18675.0,19940.0
2162,"Fayette County, Ohio",13972,909,952,592,834,818,1103,546,39,47,39047,2045,2413,3848,2198,1914,2660,4012,2761,3959,5073,7860,4959,28620,13972,14648,26802,710,282,180,615,47308,6212,11162.0,12305.0
2163,"Perry County, Ohio",18001,1154,1145,786,1016,1093,1283,792,39,127,39127,2546,3230,5201,2678,2396,3247,5026,3168,4942,6477,10227,5846,36022,18001,18021,35009,139,48,11,309,50150,8368,14995.0,16179.0
2164,"Pickaway County, Ohio",30389,1465,1577,1344,1608,1710,1830,1090,39,129,39129,5147,6582,8384,3998,3609,5104,7469,4953,8756,11686,15853,8951,57762,30389,27373,53851,2055,372,236,801,63633,12556,24745.0,27630.0
2165,"Madison County, Ohio",23954,1179,1266,788,1037,1400,1288,750,39,97,39097,3872,5566,6910,3008,2562,3710,5728,3706,6434,9276,12638,6714,44135,23954,20181,39820,2602,310,58,900,68022,9214,17290.0,19309.0
2166,"Muskingum County, Ohio",41716,2617,2816,1818,2595,2556,2856,1695,39,119,39119,6526,7375,11323,6476,6642,7571,11939,8561,13168,14946,23262,15037,86131,41716,44415,79042,2779,385,385,967,47254,17015,36991.0,39693.0
2167,"Sandusky County, Ohio",29301,1738,1846,1330,1561,1747,1865,1157,39,143,39143,3957,5271,8192,4817,3874,5147,8297,6080,7831,10418,16489,10897,59029,29301,29728,53834,1766,223,1365,5858,54089,11981,28044.0,29490.0
2168,"Van Wert County, Ohio",13936,882,991,619,854,871,965,577,39,161,39161,1980,2458,3829,2316,1915,2340,3889,2914,3895,4798,7718,5230,28261,13936,14325,27219,371,81,158,960,54254,6207,13770.0,14767.0
2169,"Washington County, Ohio",29883,1541,1418,1116,1420,1413,1892,1061,39,167,39167,4624,5010,8652,5495,4159,5088,8629,6881,8783,10098,17281,12376,60426,29883,30543,57903,781,387,157,665,50021,12920,29840.0,31382.0
2170,"Auglaize County, Ohio",22693,1378,1599,968,1486,1523,1471,1003,39,11,39011,3272,3889,6328,3626,3002,3767,6224,4560,6274,7656,12552,8186,45729,22693,23036,44142,292,216,400,770,64074,10106,23627.0,25396.0
2171,"Darke County, Ohio",25458,1555,1941,1165,1521,1560,1835,1117,39,37,39037,3467,4308,7047,4365,3199,4192,7135,5496,6666,8500,14182,9861,51513,25458,26055,50108,385,255,143,807,55620,11522,25484.0,26621.0
2172,"Ottawa County, Ohio",20162,855,965,754,845,1023,1077,797,39,123,39123,2267,3181,6105,4727,2196,3007,6326,5199,4463,6188,12431,9926,40632,20162,20470,38754,497,87,614,2050,59099,8811,22218.0,23525.0
2173,"Hardin County, Ohio",15568,973,1037,665,911,1089,842,642,39,65,39065,3309,2499,3786,2180,3278,2560,3817,2718,6587,5059,7603,4898,31425,15568,15857,30171,230,249,155,546,50506,6392,12294.0,12954.0
2174,"Jackson County, Ohio",15723,1015,963,711,1043,1284,991,610,39,79,39079,2299,2987,4166,2370,2172,3062,4491,3074,4471,6049,8657,5444,32450,15723,16727,31403,211,44,0,346,47550,6621,13693.0,14160.0
2175,"Huron County, Ohio",28847,1806,1807,1264,1856,1971,1919,1231,39,77,39077,4277,5147,7812,4397,3975,5081,8110,5349,8252,10228,15922,9746,58339,28847,29492,55797,792,131,373,3826,52560,12290,24834.0,26628.0
2176,"Athens County, Ohio",32827,1333,1294,944,1222,1163,1345,929,39,9,39009,11932,5261,6957,3650,11665,4954,7181,4631,23597,10215,14138,8281,65917,32827,33090,60024,1962,1728,231,1268,40905,12893,29443.0,24876.0
2177,"Adams County, Ohio",13824,876,909,631,795,952,857,600,39,1,39001,1841,2330,3884,2282,1851,2427,3896,2574,3692,4757,7780,4856,27776,13824,13952,27455,129,8,37,283,39079,5805,11359.0,11905.0
2178,"Medina County, Ohio",88299,4993,5645,4175,4492,5048,6164,3638,39,103,39103,11619,16140,25554,14066,11061,16209,26328,16741,22680,32349,51882,30807,177980,88299,89681,169681,2675,1997,713,3760,76600,40103,91373.0,104378.0
2179,"Lucas County, Ohio",208922,14143,14527,8491,13512,13101,13962,8019,39,95,39095,36137,37940,54499,29446,35916,39895,58986,38789,72053,77835,113485,68235,431102,208922,222180,310784,82120,7440,9912,30622,48736,79384,197556.0,194882.0
2180,"Noble County, Ohio",8631,366,386,219,338,474,276,228,39,121,39121,1118,1307,2493,2363,550,920,1517,1482,1668,2227,4010,3845,14416,8631,5785,13355,807,11,94,124,46897,3409,6013.0,6221.0
2181,"Bayamón Municipio, Puerto Rico",83978,3826,4816,3384,3648,4368,4591,3218,72,21,72021,16105,15528,20320,15324,14322,16873,25014,22180,30427,32401,45334,37504,178192,83978,94214,122650,15295,279,10804,176310,26420,36876,,
2182,"Canóvanas Municipio, Puerto Rico",21958,1156,1355,967,984,1338,1369,892,72,29,72029,4033,3919,5622,3367,3505,4876,6537,4129,7538,8795,12159,7496,45588,21958,23630,21976,5069,275,17979,45490,21267,8227,,
2183,"Comerío Municipio, Puerto Rico",9517,461,467,384,408,333,796,362,72,45,72045,1709,1800,2429,1543,1595,1765,2625,1823,3304,3565,5054,3366,19224,9517,9707,15803,2217,0,1064,19109,13733,2531,,
2184,"Juana Díaz Municipio, Puerto Rico",21942,1197,1432,958,1137,1408,1471,974,72,75,72075,3878,3854,5552,3578,3933,4633,6354,4300,7811,8487,11906,7878,46152,21942,24210,20820,4064,96,5357,46057,20657,8255,,
2185,"Las Marías Municipio, Puerto Rico",4179,58,282,160,178,231,273,137,72,83,72083,685,707,1077,803,670,715,1131,856,1355,1422,2208,1659,8370,4179,4191,3984,73,0,4263,8335,14135,1255,,
2186,"Corozal Municipio, Puerto Rico",16227,836,1158,675,772,834,1196,657,72,47,72047,2825,2951,4154,2660,2790,3199,4635,3190,5615,6150,8789,5850,33500,16227,17273,27122,2542,0,2793,33153,15140,5591,,
2187,"Maunabo Municipio, Puerto Rico",5240,238,362,119,223,151,445,255,72,95,72095,791,1052,1328,1079,808,877,1535,1242,1599,1929,2863,2321,10776,5240,5536,1351,9306,0,110,10651,20844,1401,,
2188,"Ponce Municipio, Puerto Rico",67111,3451,3664,2759,3263,3948,3901,2664,72,113,72113,12559,11875,15836,12482,11266,12039,18769,16710,23825,23914,34605,29192,139671,67111,72560,108236,8050,69,10293,138570,17069,30017,,
2189,"Toa Alta Municipio, Puerto Rico",34973,1581,1820,1655,1464,2188,2269,1571,72,135,72135,6407,6991,9326,4448,6592,7665,10687,5455,12999,14656,20013,9903,72864,34973,37891,60238,5255,318,4274,71860,28834,15172,,
2190,"Toa Baja Municipio, Puerto Rico",36401,1761,2082,1604,1646,2150,2231,1569,72,137,72137,6416,7130,8829,6226,6561,7912,10968,8372,12977,15042,19797,14598,77810,36401,41409,56358,8869,0,8520,76770,25105,15385,,
2191,"Vieques Municipio, Puerto Rico",4277,271,286,44,164,292,307,144,72,147,72147,588,792,1242,866,588,449,1438,983,1176,1241,2680,1849,8642,4277,4365,4730,651,14,3151,8204,14936,1753,,
2192,"Yabucoa Municipio, Puerto Rico",16202,680,1008,675,645,955,881,647,72,151,72151,2582,2754,4474,3050,2712,3007,4867,3583,5294,5761,9341,6633,33499,16202,17297,6244,26418,11,463,33472,16295,4647,,
2193,"Aguada Municipio, Puerto Rico",18564,785,1183,718,757,886,1105,691,72,3,72003,3097,3408,5315,3232,2993,3462,5829,3667,6090,6870,11144,6899,37954,18564,19390,32382,908,0,1194,35100,16738,6681,,
2194,"Caguas Municipio, Puerto Rico",59932,2640,3315,2636,2627,3438,3739,2504,72,25,72025,10283,11351,15286,10309,10590,12915,18290,14902,20873,24266,33576,25211,128937,59932,69005,98380,10784,220,15275,127119,25136,30262,,
2195,"Cidra Municipio, Puerto Rico",19180,928,935,800,896,1308,969,787,72,41,72041,3281,3507,5255,3063,3184,3941,5750,3592,6465,7448,11005,6655,39607,19180,20427,28632,3632,64,1684,39346,19726,7660,,
2196,"Coamo Municipio, Puerto Rico",18878,864,1002,757,781,1063,1298,708,72,43,72043,2849,3582,5259,3123,2764,4169,5671,3574,5613,7751,10930,6697,38906,18878,20028,25866,11268,0,1685,38650,19692,8472,,
2197,"Dorado Municipio, Puerto Rico",17500,844,1027,844,838,1166,1221,789,72,51,72051,2703,3483,4541,2759,2784,3925,5125,3455,5487,7408,9666,6214,36803,17500,19303,28643,4700,47,1520,35994,30732,7773,,
2198,"Luquillo Municipio, Puerto Rico",8544,375,476,364,371,549,507,386,72,89,72089,1450,1436,2157,1744,1559,1784,2462,2062,3009,3220,4619,3806,18224,8544,9680,10988,1720,32,5075,17992,21850,3292,,
2199,"Barranquitas Municipio, Puerto Rico",13978,816,910,611,759,906,872,582,72,19,72019,2689,2516,3548,1932,2520,2594,3817,2365,5209,5110,7365,4297,28393,13978,14415,24365,1214,0,1063,28359,17036,5323,,
2200,"Orocovis Municipio, Puerto Rico",10500,563,637,470,515,435,761,403,72,107,72107,1904,1805,2815,1635,1800,1838,2941,1789,3704,3643,5756,3424,20982,10500,10482,16957,733,0,2022,20904,15099,3645,,
2201,"San Lorenzo Municipio, Puerto Rico",18100,766,1247,737,773,1039,970,709,72,129,72129,2980,3340,5007,3146,3018,3574,5420,3606,5998,6914,10427,6752,37209,18100,19109,23337,11766,49,617,37125,19380,5325,,
2202,"Ceiba Municipio, Puerto Rico",5454,310,236,234,167,266,350,217,72,37,72037,950,897,1262,1171,950,1069,1586,1456,1900,1966,2848,2627,11515,5454,6061,7046,1009,19,3002,11330,18309,2095,,
2203,"Ciales Municipio, Puerto Rico",8025,402,435,313,412,496,476,298,72,39,72039,1266,1367,2217,1537,1334,1435,2379,1658,2600,2802,4596,3195,16513,8025,8488,15416,250,12,287,16371,16867,3024,,
2204,"Isabela Municipio, Puerto Rico",20282,815,1079,846,794,1172,1055,775,72,71,72071,3393,3845,5322,3652,3202,4028,5985,4414,6595,7873,11307,8066,41707,20282,21425,27363,2107,0,11826,41122,16540,8161,,
2205,"Jayuya Municipio, Puerto Rico",7186,179,401,496,565,456,467,116,72,73,72073,1344,1351,1769,1096,1180,1381,1946,1242,2524,2732,3715,2338,14539,7186,7353,8421,357,6,5272,14491,14808,2115,,
2206,"Lares Municipio, Puerto Rico",12636,613,640,503,541,596,776,476,72,81,72081,2059,2348,3316,2372,1965,2365,3577,2764,4024,4713,6893,5136,25696,12636,13060,18200,188,0,7251,25560,16532,4143,,
2207,"San Juan Municipio, Puerto Rico",153454,7477,8930,6065,7109,7950,8942,6242,72,127,72127,26204,27595,39588,29453,28506,31729,47636,43900,54710,59324,87224,73353,335468,153454,182014,219146,44472,1199,51470,328580,22710,74764,,
2208,"Vega Alta Municipio, Puerto Rico",17781,856,1000,796,834,1063,1243,739,72,143,72143,3104,3283,4422,2932,3125,3726,4956,3639,6229,7009,9378,6571,37106,17781,19325,26510,3926,49,5724,36521,20048,6181,,
2209,"Maricao Municipio, Puerto Rico",3014,143,140,118,132,159,174,100,72,93,72093,467,567,822,563,436,553,901,606,903,1120,1723,1169,6075,3014,3061,2699,92,0,3214,6021,12441,375,,
2210,"Seneca County, Ohio",27623,1541,1667,1208,1434,1611,1694,1096,39,147,39147,4830,4827,7339,4274,4394,4654,7444,5401,9224,9481,14783,9675,55351,27623,27728,51886,1716,344,339,2836,52500,12133,23987.0,25322.0
2211,"Stark County, Ohio",181002,10812,10985,7577,10128,10275,11607,7084,39,151,39151,27769,31195,49897,30814,27327,32143,52913,39925,55096,63338,102810,70739,372404,181002,191402,326746,27880,3432,2339,7732,53860,76370,175239.0,185714.0
2212,"Coshocton County, Ohio",18120,1224,1245,808,1089,1182,1088,736,39,31,39031,2463,3045,4992,3092,2434,3042,5038,3856,4897,6087,10030,6948,36585,18120,18465,35436,419,107,28,389,46606,8185,15552.0,16348.0
2213,"Delaware County, Ohio",99700,6333,7687,4935,6126,7583,7806,4704,39,41,39041,12134,20582,27398,12108,11787,21628,27422,14379,23921,42210,54820,26487,201135,99700,101435,175014,6845,12716,1036,5253,106908,50954,103860.0,124004.0
2214,"Geauga County, Ohio",46444,2507,2768,2301,2432,2813,3333,2115,39,55,39055,6201,6771,13853,8579,5527,6906,14271,10002,11728,13677,28124,18581,93843,46444,47399,90764,1276,620,94,1422,82303,21056,49941.0,55381.0
2215,"Hocking County, Ohio",13914,746,772,595,852,880,874,602,39,73,39073,1859,2417,4096,2478,1865,2427,4193,2783,3724,4844,8289,5261,28390,13914,14476,27545,218,63,37,284,52363,6485,12838.0,13786.0
2216,"Lake County, Ohio",112407,5916,6730,4527,5506,5985,6930,4297,39,85,39085,16322,19972,32798,19469,15412,19707,34395,25315,31734,39679,67193,44784,229954,112407,117547,209296,9947,2838,2198,10081,64466,49402,116246.0,127867.0
2217,"Ross County, Ohio",40332,2167,2388,1572,2019,2244,2271,1453,39,141,39141,6096,8408,11730,5544,4777,6582,10425,6845,10873,14990,22155,12389,76948,40332,36616,69541,4050,392,379,978,51092,16852,30380.0,32531.0
2218,"Cuyahoga County, Ohio",594606,36705,34107,23392,35065,34465,35873,22761,39,35,39035,99827,108988,160239,92562,101809,116310,177757,128805,201636,225298,337996,221367,1247451,594606,652845,778519,368969,37879,19535,74024,50366,247256,603822.0,605268.0
2219,"Holmes County, Ohio",21904,1882,1996,1223,1723,1815,2060,1260,39,75,39075,3796,3645,4727,2656,3515,3669,4752,3203,7311,7314,9479,5859,43901,21904,21997,43219,60,114,28,423,63753,5552,11054.0,12809.0
2220,"Miami County, Ohio",52106,3134,3409,2274,3019,3197,3394,2156,39,109,39109,7187,9480,14208,8601,6810,9436,14502,10751,13997,18916,28710,19352,105371,52106,53265,98717,2130,1317,253,1774,61041,21907,52734.0,56968.0
2221,"Monroe County, Ohio",6931,355,401,258,343,453,361,305,39,111,39111,815,1095,2011,1553,794,1118,1947,1690,1609,2213,3958,3243,13942,6931,7011,13694,53,65,1,168,45289,3382,6795.0,7066.0
2222,"Trumbull County, Ohio",97661,5481,5790,3939,5110,5472,5858,3798,39,155,39155,14244,16393,27325,18609,13365,16436,29153,23514,27609,32829,56478,42123,200367,97661,102706,177380,16468,1047,251,3639,47280,43858,96029.0,98677.0
2223,"Wood County, Ohio",64210,3550,3933,2446,3349,3694,3510,2257,39,173,39173,15369,11198,15345,8517,15719,10730,15909,10772,31088,21928,31254,19289,130150,64210,65940,119595,3416,2180,1342,7228,62390,27161,64341.0,65860.0
2224,"Ashland County, Ohio",26144,1551,1805,1121,1485,1639,1728,1164,39,5,39005,4342,4364,6880,4422,4472,4265,7242,5397,8814,8629,14122,9819,53536,26144,27392,51783,397,352,143,739,52823,11948,24590.0,25883.0
2225,"Dewey County, Oklahoma",2435,142,196,124,181,228,169,103,40,43,40043,337,409,602,417,316,380,611,499,653,789,1213,916,4922,2435,2487,4385,8,6,5,371,52428,996,2248.0,2359.0
2226,"Harper County, Oklahoma",1856,105,117,92,147,211,97,65,40,59,40059,227,400,459,315,177,400,418,389,404,800,877,704,3760,1856,1904,3473,1,0,204,839,46154,598,1499.0,1487.0
2227,"Logan County, Oklahoma",23132,1417,1487,1033,1361,1420,1540,919,40,83,40083,3569,4561,5976,3392,3692,4506,6473,3640,7261,9067,12449,7032,46683,23132,23551,38746,3834,174,122,2891,65357,8989,18979.0,21574.0
2228,"Tulsa County, Oklahoma",315509,23950,23450,13439,22450,21697,22777,12938,40,143,40143,53333,64042,75576,38774,53471,65537,80319,51721,106804,129579,155895,90495,646419,315509,330910,452799,65036,21724,22817,82309,55517,117414,247054.0,266678.0
2229,"Washington County, Oklahoma",25270,1660,1791,1073,1609,1703,1718,972,40,147,40147,3748,4489,6360,4329,3502,4625,6827,5660,7250,9114,13187,9989,51886,25270,26616,39881,1406,1156,761,3116,54997,10573,22224.0,23501.0
2230,"Harmon County, Oklahoma",1327,57,126,78,53,140,105,20,40,57,40057,168,242,377,202,175,236,348,306,343,478,725,508,2710,1327,1383,1757,254,20,473,789,48344,411,977.0,933.0
2231,"Haskell County, Oklahoma",6285,422,398,292,385,376,438,259,40,61,40061,886,1110,1525,1163,800,1083,1709,1352,1686,2193,3234,2515,12687,6285,6402,9179,108,90,139,560,42348,2266,4738.0,5014.0
2232,"Okmulgee County, Oklahoma",19163,1314,1287,865,1072,1182,1355,763,40,111,40111,3291,3139,4846,3039,2860,3324,5018,4012,6151,6463,9864,7051,38749,19163,19586,25073,3168,169,197,1623,42998,5944,13949.0,14313.0
2233,"Osage County, Oklahoma",23662,1238,1486,974,1169,1379,1611,982,40,113,40113,3385,4220,6539,4216,2944,3923,6668,4888,6329,8143,13207,9104,47226,23662,23564,30589,5266,204,526,1704,49103,8585,18966.0,20538.0
2234,"Jefferson County, Oklahoma",3102,206,242,131,199,164,249,122,40,67,40067,421,550,820,545,359,480,793,690,780,1030,1613,1235,6158,3102,3056,5224,85,1,193,651,39895,1195,2350.0,2385.0
2235,"Garfield County, Oklahoma",30940,2141,2199,1235,2291,1842,2260,1244,40,47,40047,5509,6044,7232,4218,4599,5888,7191,5643,10108,11932,14423,9861,61898,30940,30958,50726,1497,558,2357,7694,54006,11143,21710.0,22430.0
2236,"Garvin County, Oklahoma",13796,963,947,678,905,914,970,569,40,49,40049,1956,2619,3357,2228,1872,2515,3591,2703,3828,5134,6948,4931,27835,13796,14039,23160,637,85,142,2464,47125,5363,10546.0,10922.0
2237,"Pittsburg County, Oklahoma",22433,1322,1339,851,1281,1545,1216,776,40,121,40121,3446,4513,5563,3915,2935,3620,5648,4692,6381,8133,11211,8607,44146,22433,21713,32189,1261,153,320,2236,46784,7976,17271.0,17924.0
2238,"Pontotoc County, Oklahoma",18832,1304,1231,760,1226,1195,1260,697,40,123,40123,3753,3419,4286,2753,3613,3495,4518,3519,7366,6914,8804,6272,38355,18832,19523,26364,972,298,420,2058,50392,7274,14831.0,15320.0
2239,"Roger Mills County, Oklahoma",1800,126,137,57,106,125,155,77,40,129,40129,188,307,510,321,231,319,435,419,419,626,945,740,3667,1800,1867,3232,9,0,78,264,51302,633,1759.0,1834.0
2240,"Woodward County, Oklahoma",10955,755,871,423,741,768,674,381,40,153,40153,1702,2532,2656,1399,1394,1836,2269,1709,3096,4368,4925,3108,20727,10955,9772,18541,264,56,611,2663,60147,4121,7595.0,7785.0
2241,"Cherokee County, Oklahoma",23831,1424,1500,971,1467,1508,1564,868,40,21,40021,5191,4197,5357,3654,5188,4185,5769,4284,10379,8382,11126,7938,48664,23831,24833,24777,661,359,1076,3482,42774,8740,16490.0,17714.0
2242,"Delaware County, Oklahoma",20908,1106,1152,780,1062,1246,1132,816,40,41,40041,2684,3130,5640,5020,2598,3317,6026,5328,5282,6447,11666,10348,42433,20908,21525,27710,199,520,453,1618,41696,7047,15716.0,17245.0
2243,"Ellis County, Oklahoma",1930,116,131,72,126,135,166,79,40,45,40045,233,304,565,403,236,348,494,501,469,652,1059,904,4015,1930,2085,3692,7,27,43,287,53245,807,1827.0,1873.0
2244,"Grady County, Oklahoma",27629,1689,1734,1284,1501,1715,1964,1098,40,51,40051,3997,5137,7464,4011,3710,5276,7443,4735,7707,10413,14907,8746,55071,27629,27442,47267,1295,283,352,3207,60875,11133,22286.0,23101.0
2245,"Payne County, Oklahoma",41976,2213,2327,1427,2142,2127,2042,1079,40,119,40119,15291,6771,7184,4467,13142,6267,7445,5595,28433,13038,14629,10062,81815,41976,39839,65946,3251,3523,517,3858,41603,15569,27760.0,29643.0
2246,"Pottawatomie County, Oklahoma",34523,2324,2455,1572,2143,2365,2463,1486,40,125,40125,5626,6363,8591,5148,6110,7127,9537,6400,11736,13490,18128,11548,72154,34523,37631,54752,2505,472,416,3730,49250,12185,25452.0,28185.0
2247,"Creek County, Oklahoma",35298,2275,2268,1535,2188,2244,2442,1458,40,37,40037,5121,6417,9446,5584,4879,6284,9788,6846,10000,12701,19234,12430,71427,35298,36129,56527,1533,310,477,3015,51318,13120,28830.0,30505.0
2248,"Tillman County, Oklahoma",3782,175,266,183,248,253,231,126,40,141,40141,527,574,1116,666,430,548,1007,788,957,1122,2123,1454,7413,3782,3631,4846,562,16,1219,2005,42280,1015,2706.0,2708.0
2249,"Washita County, Oklahoma",5622,398,475,263,340,325,435,220,40,149,40149,779,1006,1499,838,744,974,1429,1136,1523,1980,2928,1974,11225,5622,5603,10032,142,8,305,1098,53274,2402,4631.0,4777.0
2250,"Cotton County, Oklahoma",2962,141,174,156,137,153,219,95,40,33,40033,418,499,782,530,379,478,827,608,797,977,1609,1138,5858,2962,2896,4695,133,0,72,466,50885,1036,2602.0,2572.0
2251,"Kiowa County, Oklahoma",4440,311,338,186,234,288,339,169,40,75,40075,564,783,1227,789,526,713,1237,940,1090,1496,2464,1729,8886,4440,4446,7078,302,57,414,1049,38019,1613,3493.0,3427.0
2252,"Le Flore County, Oklahoma",25079,1627,1736,1070,1579,1612,1734,995,40,79,40079,3679,4790,6383,3971,3459,4317,6450,4801,7138,9107,12833,8772,50026,25079,24947,37793,952,347,925,3511,40677,9089,17221.0,18805.0
2253,"McCurtain County, Oklahoma",16326,1204,1218,730,1142,1068,1212,639,40,89,40089,2455,2792,4062,2672,2356,2830,4273,3170,4811,5622,8335,5842,33016,16326,16690,21022,2599,274,771,2001,37061,5621,10726.0,11467.0
2254,"Major County, Oklahoma",3804,245,429,150,268,220,343,147,40,93,40093,472,661,991,680,442,635,996,837,914,1296,1987,1517,7692,3804,3888,6865,32,67,238,743,54332,1402,3407.0,3467.0
2255,"Mayes County, Oklahoma",20458,1260,1519,930,1193,1349,1305,827,40,97,40097,3002,3528,5491,3427,2902,3526,5447,4037,5904,7054,10938,7464,41044,20458,20586,27301,221,177,217,1479,50345,6721,15717.0,16626.0
2256,"Oklahoma County, Oklahoma",385353,30285,28403,15522,29205,27213,27186,15080,40,109,40109,68052,80032,88876,45621,67642,80938,95093,59506,135694,160970,183969,105127,787216,385353,401863,539029,117836,26573,28683,136829,54520,145126,273942.0,294740.0
2257,"Custer County, Oklahoma",14290,985,1196,624,1146,1171,930,553,40,39,40039,3435,2456,3156,1679,3333,2424,3071,2234,6768,4880,6227,3913,29152,14290,14862,23391,903,352,1154,5322,49900,4581,10541.0,10691.0
2258,"Love County, Oklahoma",5024,321,384,229,308,280,466,197,40,85,40085,732,849,1247,961,712,875,1216,985,1444,1724,2463,1946,10063,5024,5039,8402,263,82,229,1580,49399,1827,3789.0,4076.0
2259,"Beckham County, Oklahoma",12115,763,762,464,827,581,953,386,40,9,40009,2100,2748,3083,1367,1446,1874,2443,1643,3546,4622,5526,3010,22268,12115,10153,18816,944,76,984,3241,50721,3926,7552.0,7948.0
2260,"Choctaw County, Oklahoma",7094,482,439,299,518,487,532,258,40,23,40023,964,1092,1863,1375,993,1243,2052,1630,1957,2335,3915,3005,14807,7094,7713,9300,1631,13,151,649,34489,2222,5426.0,5832.0
2261,"Jackson County, Oklahoma",12558,1042,845,508,919,961,749,469,40,65,40065,2517,2524,2622,1630,2053,2439,2828,2087,4570,4963,5450,3717,25063,12558,12505,18005,1716,331,2821,6043,49703,3612,7806.0,8221.0
2262,"Lincoln County, Oklahoma",17381,1049,1236,756,1039,1247,1106,746,40,81,40081,2386,2901,4841,2914,2254,2963,4818,3341,4640,5864,9659,6255,34895,17381,17514,29620,677,114,102,1199,50671,6489,14025.0,14888.0
2263,"Pawnee County, Oklahoma",8225,505,513,360,441,506,562,343,40,117,40117,1119,1366,2244,1445,1022,1402,2263,1648,2141,2768,4507,3093,16412,8225,8187,12891,169,60,38,507,48009,3266,6364.0,6786.0
2264,"Seminole County, Oklahoma",12172,831,852,560,800,745,923,568,40,133,40133,1861,2087,3089,1954,1768,2167,3250,2439,3629,4254,6339,4393,24832,12172,12660,16894,1195,140,128,1276,39373,3707,8037.0,8337.0
2265,"Cimarron County, Oklahoma",1065,69,84,31,77,74,73,59,40,25,40025,123,160,261,247,114,168,262,282,237,328,523,529,2174,1065,1109,2134,4,6,17,487,46328,458,1079.0,1054.0
2266,"Blaine County, Oklahoma",5091,290,313,164,228,299,261,147,40,11,40011,684,1104,1476,797,470,781,1346,933,1154,1885,2822,1730,9556,5091,4465,7608,399,2,294,1063,45792,1786,3793.0,3901.0
2267,"Coal County, Oklahoma",2813,198,198,137,169,145,199,106,40,29,40029,394,437,728,499,345,448,706,650,739,885,1434,1149,5581,2813,2768,3909,11,24,95,260,40938,1019,2399.0,2524.0
2268,"Grant County, Oklahoma",2212,127,176,103,117,150,176,100,40,53,40053,288,351,625,417,258,326,547,511,546,677,1172,928,4397,2212,2185,3978,41,8,92,222,57727,1008,2201.0,2226.0
2269,"Kingfisher County, Oklahoma",7865,556,674,375,523,540,687,312,40,73,40073,1138,1440,2000,1108,1078,1403,1949,1337,2216,2843,3949,2445,15694,7865,7829,13364,200,60,1033,2501,57777,3052,6131.0,6465.0
2270,"McClain County, Oklahoma",19461,1209,1569,927,1095,1552,1383,833,40,87,40087,2590,3844,5044,2769,2581,3939,5203,3200,5171,7783,10247,5969,39247,19461,19786,33221,464,114,659,3151,67662,7360,16858.0,19236.0
2271,"Marshall County, Oklahoma",8173,486,505,375,469,498,634,305,40,95,40095,1166,1269,2020,1771,1003,1293,2228,1902,2169,2562,4248,3673,16505,8173,8332,11591,283,34,1913,2921,45746,2692,5492.0,6064.0
2272,"Noble County, Oklahoma",5601,365,423,234,346,405,409,207,40,103,40103,782,966,1486,968,694,1004,1502,1167,1476,1970,2988,2135,11335,5601,5734,9392,30,9,77,439,56117,2484,4878.0,4938.0
2273,"Nowata County, Oklahoma",5091,320,353,197,294,377,286,208,40,105,40105,679,913,1399,891,703,845,1431,1087,1382,1758,2830,1978,10322,5091,5231,7007,253,15,151,318,43145,1685,4237.0,4391.0
2274,"Rogers County, Oklahoma",45473,2782,3082,2088,2547,2676,3305,2005,40,131,40131,7076,8211,12209,6801,6698,8413,12480,7756,13774,16624,24689,14557,91353,45473,45880,68194,940,1309,1004,4345,65434,17426,40862.0,44553.0
2275,"Sequoyah County, Oklahoma",20574,1384,1314,933,1269,1177,1463,849,40,135,40135,3055,3512,5438,3441,2912,3660,5711,4094,5967,7172,11149,7535,41709,20574,21135,26776,813,340,579,1753,40351,6825,14437.0,15386.0
2276,"Alfalfa County, Oklahoma",3531,184,173,87,128,124,192,90,40,3,40003,335,906,1143,558,301,338,580,563,636,1244,1723,1121,5847,3531,2316,4986,181,0,179,329,61852,1259,2258.0,2262.0
2277,"Woods County, Oklahoma",4767,257,303,131,301,226,250,152,40,151,40151,1312,907,941,677,990,634,893,830,2302,1541,1834,1507,9043,4767,4276,8005,276,106,53,661,54282,1910,3668.0,3678.0
2278,"Cleveland County, Oklahoma",139416,7758,8759,5402,7429,8280,8550,5257,40,27,40027,32230,28798,31247,16056,30024,27557,32545,20216,62254,56355,63792,36272,279274,139416,139858,216953,13123,12443,4668,24275,64016,53625,109450.0,119778.0
2279,"Okfuskee County, Oklahoma",6487,321,398,237,364,442,343,208,40,107,40107,1031,1284,1757,991,732,945,1422,1124,1763,2229,3179,2115,12067,6487,5580,7657,895,0,73,481,38411,2042,3943.0,4038.0
2280,"Atoka County, Oklahoma",7289,451,438,277,344,448,426,282,40,5,40005,1141,1541,1798,1206,850,1071,1731,1382,1991,2612,3529,2588,13823,7289,6534,10049,495,99,84,486,39316,2532,5018.0,5389.0
2281,"Union County, Oregon",13083,800,782,520,730,860,668,514,41,61,41061,2195,2343,3050,2467,2266,2116,3284,2816,4461,4459,6334,5283,26337,13083,13254,24158,198,297,201,1276,52171,5042,12968.0,14862.0
2282,"Marion County, Oregon",169275,11676,11802,7198,10976,11250,11993,6739,41,47,41047,28772,33737,40436,23044,26996,32000,41363,29049,55768,65737,81799,52093,339641,169275,170366,275985,4194,6999,24060,90277,59625,54876,136840.0,161287.0
2283,"Douglas County, Oregon",53868,2890,3101,1974,2757,2537,3175,1794,41,19,41019,6885,8671,14309,13104,6555,8587,15395,14446,13440,17258,29704,27550,109114,53868,55246,100807,462,1078,665,6337,47267,19663,53521.0,63107.0
2284,"Jefferson County, Oregon",12222,771,895,468,706,660,899,421,41,31,41031,1841,2111,3139,2259,1556,1834,3022,2287,3397,3945,6161,4546,23607,12222,11385,16713,182,146,1501,4715,53277,3686,9459.0,11666.0
2285,"Polk County, Oregon",40552,2323,2583,1783,2375,2715,2547,1642,41,53,41053,7791,7057,9286,6762,7858,7370,10171,7807,15649,14427,19457,14569,83037,40552,42485,73159,686,1542,2515,11545,62691,14914,40295.0,47279.0
2286,"Deschutes County, Oregon",91931,4813,5415,3471,4741,5564,4996,3140,41,17,41017,12515,18594,23961,17422,12009,18498,26344,19028,24524,37092,50305,36450,186251,91931,94320,173615,1188,2067,2352,14853,67043,40942,98557.0,121732.0
2287,"Linn County, Oregon",61638,3770,4242,2467,3721,3819,3842,2542,41,43,41043,9347,11348,15895,10562,9115,11567,16471,12333,18462,22915,32366,22895,125048,61638,63410,112036,627,1344,3997,11393,55893,21098,58719.0,71148.0
2288,"Yamhill County, Oregon",52422,2949,3258,2164,3002,3412,3041,2040,41,71,41071,8730,10392,13231,8009,8414,9647,13258,9595,17144,20039,26489,17604,104831,52422,52409,91772,878,1525,4788,16639,63902,18513,48753.0,55084.0
2289,"Baker County, Oregon",8257,437,525,261,353,470,383,271,41,1,41001,1044,1417,2111,2028,740,1269,2153,2123,1784,2686,4264,4151,16019,8257,7762,14844,147,109,312,691,45998,3327,8779.0,9878.0
2290,"Klamath County, Oregon",33404,2051,2128,1244,2050,2074,1835,1165,41,35,41035,5129,5681,8506,6688,4726,5497,9009,7161,9855,11178,17515,13849,66921,33404,33517,58240,483,682,1531,8740,46491,12151,30507.0,36331.0
2291,"Lincoln County, Oregon",23393,1120,1195,745,1055,1299,1031,639,41,41,41041,2675,3479,6696,6357,2510,3693,7750,7177,5185,7172,14446,13534,48547,23393,25154,42835,271,603,1159,4447,47882,9522,25256.0,30441.0
2292,"Benton County, Oregon",45794,1889,2154,1371,1784,1513,2608,1465,41,3,41003,14805,7150,9641,6654,12897,7181,10374,7491,27702,14331,20015,14145,91107,45794,45313,77177,982,6528,1696,6740,62077,20046,48753.0,52134.0
2293,"Crook County, Oregon",11347,610,669,458,565,634,644,416,41,13,41013,1306,1818,3091,2832,1355,1907,3262,2881,2661,3725,6353,5713,23011,11347,11664,21410,126,80,378,1753,49006,4364,12172.0,15165.0
2294,"Sherman County, Oregon",882,40,38,36,20,50,37,19,41,55,41055,102,162,262,205,69,131,211,223,171,293,473,428,1642,882,760,1504,3,2,12,81,51071,329,1017.0,1197.0
2295,"Harney County, Oregon",3736,204,268,131,178,225,130,143,41,25,41025,428,637,1005,843,374,628,960,893,802,1265,1965,1736,7267,3736,3531,6654,35,0,9,371,40735,1455,3974.0,4465.0
2296,"Malheur County, Oregon",16551,1028,1117,614,1033,1081,1152,619,41,45,41045,3030,3462,3816,2412,2072,2163,3152,2589,5102,5625,6968,5001,30412,16551,13861,27291,345,430,1002,10257,43313,4352,10435.0,11653.0
2297,"Wallowa County, Oregon",3444,159,206,93,183,165,169,105,41,63,41063,288,563,935,997,318,508,1131,981,606,1071,2066,1978,7004,3444,3560,6647,12,18,65,217,51224,1446,4366.0,5128.0
2298,"Wheeler County, Oregon",713,54,35,15,49,23,27,11,41,69,41069,79,70,175,259,92,55,198,247,171,125,373,506,1415,713,702,1319,0,4,25,122,40926,314,818.0,963.0
2299,"Morrow County, Oregon",5720,424,328,297,422,438,396,261,41,49,41049,837,977,1432,878,759,967,1454,886,1596,1944,2886,1764,11303,5720,5583,10131,30,70,513,4126,54269,1406,4167.0,5060.0
2300,"Coos County, Oregon",31494,1476,1557,1165,1683,1418,1560,950,41,11,41011,3850,5044,8677,7747,3887,4982,9236,8476,7737,10026,17913,16223,63686,31494,32192,56319,327,652,1344,4139,45051,11332,31313.0,36484.0
2301,"Curry County, Oregon",11173,428,447,227,505,492,388,295,41,15,41015,1218,1496,3143,3697,884,1549,3438,3926,2102,3045,6581,7623,22650,11173,11477,20583,99,118,66,1612,48440,4780,12611.0,14843.0
2302,"Gilliam County, Oregon",897,29,78,37,45,47,66,36,41,21,41021,99,124,267,228,79,137,324,247,178,261,591,475,1878,897,981,1725,0,15,12,115,47500,306,1019.0,1172.0
2303,"Hood River County, Oregon",11598,712,634,545,737,737,819,484,41,27,41027,1692,2279,3190,1617,1541,2230,3071,1992,3233,4509,6261,3609,23209,11598,11611,20679,136,383,996,7293,65679,4417,10910.0,12745.0
2304,"Lake County, Oregon",4194,204,216,143,173,214,220,134,41,37,41037,485,739,1199,1035,357,538,1113,894,842,1277,2312,1929,7837,4194,3643,7193,27,85,50,640,37898,1540,3930.0,4336.0
2305,"Multnomah County, Oregon",398513,22801,22349,12356,21381,21528,20110,11653,41,51,41051,68486,105374,99875,46369,70261,103129,99501,58530,138747,208503,199376,104899,804606,398513,406093,627124,43988,59715,18017,93276,69176,199988,399103.0,456058.0
2306,"Pike County, Pennsylvania",28148,965,1491,1299,929,978,1759,973,42,103,42103,3794,4228,8864,5869,3278,4112,8993,6283,7072,8340,17857,12152,55453,28148,27305,49074,3526,661,766,6052,65928,13005,26101.0,32179.0
2307,"Snyder County, Pennsylvania",20143,1157,1185,761,1012,1078,1242,720,42,109,42109,3690,3240,5502,3288,3557,3269,5331,4131,7247,6509,10833,7419,40483,20143,20340,39022,425,275,221,867,58997,9074,16363.0,18945.0
2308,"Susquehanna County, Pennsylvania",20601,942,981,746,903,1111,1067,702,42,115,42115,2643,3143,6464,4427,2286,3023,6321,4956,4929,6166,12785,9383,40970,20601,20369,39944,275,157,131,704,54966,10144,18863.0,21325.0
2309,"Crawford County, Pennsylvania",41716,2331,2507,1696,2357,2318,2452,1628,42,39,42039,6289,6610,11692,7943,6555,7054,12388,9197,12844,13664,24080,17140,85665,41716,43949,81795,1384,485,248,1119,50304,20573,37492.0,41150.0
2310,"Erie County, Pennsylvania",135238,7883,8509,5441,7575,7891,8113,5076,42,49,42049,23646,24039,36259,21034,22546,23646,37267,26483,46192,47685,73526,47517,273835,135238,138597,236779,19663,4538,3350,11532,51529,61205,123679.0,135657.0
2311,"Fulton County, Pennsylvania",7322,384,444,269,312,432,412,264,42,57,42057,977,1216,2205,1426,881,1174,2095,1614,1858,2390,4300,3040,14506,7322,7184,14009,221,38,35,174,53476,3683,6771.0,7807.0
2312,"Juniata County, Pennsylvania",12304,696,745,520,720,795,709,557,42,67,42067,1625,2125,3472,2290,1557,1962,3414,2606,3182,4087,6886,4896,24624,12304,12320,23882,270,97,210,941,53879,5436,10454.0,12058.0
2313,"Schuylkill County, Pennsylvania",72953,3594,3936,2666,3398,3721,4131,2414,42,107,42107,10216,14163,21395,12635,8307,11643,20181,15926,18523,25806,41576,28561,142674,72953,69721,133647,4538,703,1464,6284,52280,33525,62869.0,69649.0
2314,"Wyoming County, Pennsylvania",13779,663,813,531,655,759,654,515,42,131,42131,2125,2250,3958,2674,1853,2160,4028,2924,3978,4410,7986,5598,27327,13779,13548,26534,297,60,31,513,59415,6750,13144.0,14716.0
2315,"Adams County, Pennsylvania",50461,2605,2856,1892,2586,2730,3022,1906,42,1,42001,7824,8197,14603,9277,7516,7988,15234,11027,15340,16185,29837,20304,102470,50461,52009,95038,1468,732,2740,7267,67253,22341,47489.0,55814.0
2316,"Armstrong County, Pennsylvania",32761,1639,2013,1145,1586,1841,1660,1115,42,5,42005,4234,5486,10131,6433,3846,5356,9899,7803,8080,10842,20030,14236,65867,32761,33106,64325,548,201,34,509,51410,16645,31618.0,33624.0
2317,"Clinton County, Pennsylvania",19261,1034,1147,676,1043,986,1139,669,42,35,42035,4119,2975,4873,3255,4025,2959,4967,3866,8144,5934,9840,7121,38915,19261,19654,37447,696,323,83,590,50923,8490,15394.0,17321.0
2318,"Carbon County, Pennsylvania",31777,1548,1795,1174,1410,1544,2016,1114,42,25,42025,4018,5541,9848,6064,3675,5324,9895,7132,7693,10865,19743,13196,63887,31777,32110,61135,1485,360,238,3035,57006,15028,28776.0,33018.0
2319,"Centre County, Pennsylvania",85202,3327,3511,2129,3052,2989,3621,2238,42,27,42027,28606,15036,18964,10150,23180,11970,17552,12156,51786,27006,36516,22306,161960,85202,76758,141849,6173,9923,922,4777,60403,38539,76148.0,77100.0
2320,"Northumberland County, Pennsylvania",46173,2443,2858,1762,2289,2364,2537,1472,42,97,42097,6570,8607,13233,8402,5582,7598,13006,10740,12152,16205,26239,19142,91761,46173,45588,86804,2457,379,457,3192,48671,22237,36622.0,41560.0
2321,"Northampton County, Pennsylvania",148943,7577,8446,5960,7134,7946,8878,5564,42,95,42095,25399,26288,41409,24644,22842,26627,43123,31752,48241,52915,84532,56396,302809,148943,153866,259055,17264,8497,6749,40088,70471,68884,143519.0,169403.0
2322,"Venango County, Pennsylvania",25583,1343,1433,1039,1217,1346,1449,904,42,121,42121,3335,4121,7850,5026,3003,4133,7996,6187,6338,8254,15846,11213,51818,25583,26235,50080,407,195,146,567,49945,12901,23348.0,26198.0
2323,"Beaver County, Pennsylvania",80460,4262,4675,2911,4152,4482,4363,2743,42,7,42007,11330,14158,23566,14933,10755,14161,24937,19780,22085,28319,48503,34713,165833,80460,85373,149833,9648,880,624,2661,57807,35353,83571.0,92767.0
2324,"Lackawanna County, Pennsylvania",102161,5746,6062,3834,5393,5513,6195,3720,42,69,42069,16007,18253,28122,17614,16125,18297,29540,23708,32132,36550,57662,41322,210652,102161,108491,191885,5898,5921,1978,15845,52821,47574,103456.0,113975.0
2325,"McKean County, Pennsylvania",21416,1077,1285,825,977,1177,1021,714,42,83,42083,3382,3997,6162,3562,2834,3263,5678,4321,6216,7260,11840,7883,41401,21416,19985,39132,1048,212,309,868,48647,9802,16296.0,19195.0
2326,"Fayette County, Pennsylvania",64835,3328,3361,2290,3365,3374,3472,2380,42,51,42051,9532,11552,19079,11918,8340,10937,19435,15164,17872,22489,38514,27082,131302,64835,66467,121435,5502,474,615,1611,47364,31741,53767.0,59952.0
2327,"Montgomery County, Pennsylvania",400410,23294,23876,16270,22269,25292,24266,15703,42,91,42091,57959,77953,111820,61552,57402,78104,118791,81586,115361,156057,230611,143138,823823,400410,423413,651356,75690,62636,11293,42350,91546,225841,434687.0,501561.0
2328,"Clearfield County, Pennsylvania",42011,1999,2253,1377,1779,1942,2093,1282,42,33,42033,6020,8271,12689,7250,4592,6187,11175,8847,10612,14458,23864,16097,79908,42011,37897,75643,2302,401,224,2363,49015,19257,34271.0,39124.0
2329,"Lebanon County, Pennsylvania",68479,4266,4154,2740,4148,4500,4395,2695,42,75,42075,10113,12253,18039,11780,9829,12176,18545,14962,19942,24429,36584,26742,139729,68479,71250,121005,3449,1989,10134,18328,60281,29379,61845.0,70483.0
2330,"Lycoming County, Pennsylvania",56067,3191,3052,2057,3046,3289,3215,1934,42,81,42081,9587,9816,15071,9616,8636,10021,15985,12137,18223,19837,31056,21753,114330,56067,58263,105254,5665,809,351,2290,54241,24524,50565.0,58473.0
2331,"Montour County, Pennsylvania",8720,512,570,391,540,474,476,291,42,93,42093,1207,1612,2454,1531,1224,1629,2668,2237,2431,3241,5122,3768,18259,8720,9539,17145,328,632,14,504,58333,4968,8556.0,9812.0
2332,"Warren County, Pennsylvania",19901,985,1060,776,1002,1063,1024,718,42,123,42123,2590,3106,6141,4131,2256,3034,6007,4751,4846,6140,12148,8882,39756,19901,19855,38843,192,191,63,432,50250,9865,18434.0,20401.0
2333,"Butler County, Pennsylvania",92531,4905,5105,3793,4625,4836,5545,3322,42,19,42019,13603,16613,27650,15191,12970,16084,28152,18834,26573,32697,55802,34025,186899,92531,94368,179098,1821,2336,394,2790,70668,45673,97071.0,111017.0
2334,"Elk County, Pennsylvania",15319,795,754,552,734,630,958,552,42,47,42047,1945,2386,5015,2960,1704,2239,4647,3557,3649,4625,9662,6517,30340,15319,15021,29663,268,153,21,247,53440,7881,14426.0,16751.0
2335,"Lancaster County, Pennsylvania",264955,18241,17698,11019,17238,18325,16325,10644,42,71,42071,42854,47309,66989,42160,42709,48007,70041,52755,85563,95316,137030,94915,540999,264955,276044,478516,22580,11863,13655,56715,66056,112721,241112.0,273527.0
2336,"Mercer County, Pennsylvania",54961,2787,2762,2387,2579,2781,3096,2177,42,85,42085,8694,8982,15769,10276,7892,8660,16024,13348,16586,17642,31793,23624,111518,54961,56557,101788,6358,822,275,1670,50696,25822,52309.0,56420.0
2337,"Potter County, Pennsylvania",8389,429,500,324,451,489,459,306,42,105,42105,1069,1246,2435,1846,946,1211,2448,2107,2015,2457,4883,3953,16806,8389,8417,16346,67,59,44,229,45419,3815,7784.0,8901.0
2338,"Tioga County, Pennsylvania",20319,1142,1101,762,1000,1079,1110,725,42,117,42117,2973,3299,5641,4164,3004,3237,5848,4622,5977,6536,11489,8786,40944,20319,20625,39659,297,231,153,518,51324,10045,18325.0,21099.0
2339,"Newport County, Rhode Island",40728,1809,1742,1290,1773,2077,1875,1267,44,5,44005,6925,7244,11371,8048,6232,6666,12288,9895,13157,13910,23659,17943,82801,40728,42073,74408,3320,1616,826,4718,79454,22016,41045.0,45091.0
2340,"Providence County, Rhode Island",309399,18633,17879,11652,17697,17337,17863,11230,44,7,44007,60280,61623,79680,40324,60091,61516,85739,54865,120371,123139,165419,95189,635737,309399,326338,463567,62698,26431,53046,144826,58974,130659,248474.0,266580.0
2341,"Bristol County, Rhode Island",23599,1086,1376,1014,926,1237,1383,953,44,1,44001,4103,3598,6940,4153,3895,3829,7640,5302,7998,7427,14580,9455,48764,23599,25165,45931,650,1006,287,1486,83092,12128,25475.0,27743.0
2342,"Aiken County, South Carolina",81237,5018,5323,3294,4679,4786,5179,3295,45,3,45003,12249,14417,21791,14053,12319,15585,23734,17487,24568,30002,45525,31540,168301,81237,87064,118946,42002,1570,1043,9622,51399,31421,74851.0,85185.0
2343,"Allendale County, South Carolina",4828,245,232,198,165,188,287,135,45,5,45005,828,1064,1222,795,509,667,1263,982,1337,1731,2485,1777,9024,4828,4196,2108,6664,14,162,302,27185,1021,3592.0,3593.0
2344,"Edgefield County, South Carolina",14358,479,626,539,523,697,803,478,45,37,45037,2272,3308,4085,2259,1611,2059,3707,2691,3883,5367,7792,4950,26927,14358,12569,16163,9511,81,562,1606,49127,4363,11644.0,13304.0
2345,"Chester County, South Carolina",15703,918,841,671,905,1059,892,575,45,23,45023,2253,2539,4481,2591,2339,2780,4775,3283,4592,5319,9256,5874,32311,15703,16608,19518,11972,65,18,653,42442,4635,14192.0,15757.0
2346,"Colleton County, South Carolina",17952,748,1052,988,1365,1179,1050,640,45,29,45029,2627,3081,4698,3353,2663,3223,5434,4079,5290,6304,10132,7432,37585,17952,19633,21523,14411,54,962,1205,36324,5924,17251.0,19283.0
2347,"Marion County, South Carolina",14448,1029,1157,548,913,696,1274,652,45,67,45067,2264,2272,3844,2391,2260,2881,4630,3554,4524,5153,8474,5945,31308,14448,16860,12414,17752,223,415,884,32063,4205,14276.0,14704.0
2348,"Lexington County, South Carolina",141364,8680,9310,6046,8407,8970,10025,5804,45,63,45063,21186,27674,38148,19906,21060,29155,40638,24855,42246,56829,78786,44761,290278,141364,148914,229664,43041,5427,3976,17438,61173,58768,122093.0,144568.0
2349,"Oconee County, South Carolina",38138,1964,2408,1393,1971,2069,2259,1409,45,73,45073,5415,6052,10503,8226,5006,6021,11223,9432,10421,12073,21726,17658,77528,38138,39390,68062,5317,570,947,4235,49134,14975,33635.0,40668.0
2350,"Berkeley County, South Carolina",106983,7209,7739,4197,6696,7545,6815,4222,45,15,45015,20080,21498,25994,13127,16536,22416,28081,15750,36616,43914,54075,28877,215044,106983,108061,143238,51660,4766,6736,14206,63309,36263,79517.0,104458.0
2351,"Charleston County, South Carolina",194314,12252,11577,6141,11536,11018,10348,5946,45,19,45019,35528,42194,47886,28090,35710,42852,53698,35743,71238,85046,101584,63833,401165,194314,206851,273817,107239,6052,4760,20591,64022,88754,176345.0,218857.0
2352,"Georgetown County, South Carolina",29301,1502,1565,1127,1451,1458,1602,1113,45,43,45043,3741,4197,7828,7592,3747,4676,9482,9122,7488,8873,17310,16714,61952,29301,32651,40114,19149,317,1432,1902,48456,10842,31657.0,36668.0
2353,"Marlboro County, South Carolina",13940,740,666,519,668,867,667,517,45,69,45069,2348,3203,3614,1982,1633,2178,3613,2670,3981,5381,7227,4652,26753,13940,12813,11108,13511,116,134,887,33586,3272,10389.0,11446.0
2354,"Anderson County, South Carolina",95539,5879,6409,4150,5702,5962,6761,3847,45,7,45007,14190,16863,25732,15535,14591,18323,27725,19614,28781,35186,53457,35149,198064,95539,102525,157968,31183,1845,2158,7432,50865,33600,80483.0,96093.0
2355,"Chesterfield County, South Carolina",22590,1354,1271,985,1244,1100,1671,866,45,25,45025,3457,3757,6447,3610,3267,3930,6650,4635,6724,7687,13097,8245,45953,22590,23363,28935,14701,230,638,1985,41505,6807,16581.0,18876.0
2356,"Greenwood County, South Carolina",32719,2159,2239,1334,2203,2397,2099,1340,45,47,45047,5077,5653,8456,5402,6172,6618,9506,7357,11249,12271,17962,12759,70411,32719,37692,45307,22305,726,653,4238,42336,10774,28763.0,32006.0
2357,"Horry County, South Carolina",160275,7967,8233,5501,7865,8474,8405,5147,45,51,45051,22448,27258,43249,36306,22992,28499,49889,40626,45440,55757,93138,76932,332172,160275,171897,269392,44187,4522,6611,20050,50704,64710,132920.0,179744.0
2358,"Kershaw County, South Carolina",31563,1821,2522,1313,1835,1699,2452,1372,45,55,45055,4441,5410,8547,5219,4311,5935,9460,6485,8752,11345,18007,11704,65112,31563,33549,46360,15387,119,1062,2886,51479,11637,28995.0,33629.0
2359,"Orangeburg County, South Carolina",41012,2434,2791,1656,2381,2505,2964,1656,45,75,45075,6966,6386,10568,7178,7731,7400,12573,9465,14697,13786,23141,16643,87687,41012,46675,30474,54107,572,280,1950,37955,13439,38910.0,41205.0
2360,"Spartanburg County, South Carolina",149276,9484,10258,6387,9244,9606,10336,6005,45,83,45083,24944,27452,39031,21482,25545,28586,41502,27517,50489,56038,80533,48999,307617,149276,158341,225093,62688,7240,5180,21033,52332,52615,121090.0,148655.0
2361,"Bamberg County, South Carolina",6950,331,440,329,336,540,287,212,45,9,45009,1343,1068,1742,1281,1247,1068,1991,1745,2590,2136,3733,3026,14376,6950,7426,5237,8786,50,168,300,31422,2213,6214.0,6482.0
2362,"Beaufort County, South Carolina",91501,5101,5143,2835,4805,4628,5070,2755,45,13,45013,15918,13982,20427,23087,12306,14385,24515,26130,28224,28367,44942,49217,186095,91501,94594,138993,33027,2428,6787,20635,68377,39958,78524.0,97397.0
2363,"Calhoun County, South Carolina",7003,376,416,219,369,366,412,257,45,17,45017,931,1255,1931,1442,941,1331,2196,1788,1872,2586,4127,3230,14663,7003,7660,8169,6001,4,225,553,46339,2429,7549.0,8291.0
2364,"Dillon County, South Carolina",14513,1084,1187,638,992,1149,968,656,45,33,45033,2279,2426,3762,2003,2384,2831,4313,2883,4663,5257,8075,4886,30689,14513,16176,14340,14998,22,49,848,30812,3445,11698.0,13101.0
2365,"Saluda County, South Carolina",10141,585,693,330,651,569,531,394,45,81,45081,1490,1871,2741,1745,1276,1753,2834,2154,2766,3624,5575,3899,20303,10141,10162,13370,5091,0,1537,3137,45714,2918,8564.0,9274.0
2366,"Richland County, South Carolina",199147,12199,12249,7861,11712,11983,12533,7452,45,79,45079,50186,37985,44498,21600,47282,40916,51191,29141,97468,78901,95689,50741,411357,199147,212210,184514,192946,11752,8405,21238,54767,80364,168722.0,193822.0
2367,"Fairfield County, South Carolina",10780,551,481,317,471,499,687,518,45,39,45039,1515,1624,3352,2110,1574,1825,3697,2514,3089,3449,7049,4624,22565,10780,11785,8825,13234,41,0,494,38213,3039,11267.0,12136.0
2368,"Hampton County, South Carolina",10152,537,544,520,539,656,511,254,45,49,45049,1608,2067,2617,1590,1291,1608,2631,1922,2899,3675,5248,3512,19564,10152,9412,8227,10451,63,568,787,33429,2283,8806.0,9303.0
2369,"Greenville County, South Carolina",246053,16457,16949,9752,15460,16534,16104,9622,45,45,45045,40011,48924,62966,34271,40868,50654,67990,43718,80879,99578,130956,77989,507003,246053,260950,372871,89504,12752,15150,46399,60351,96618,215165.0,258155.0
2370,"Lancaster County, South Carolina",44504,2750,3047,1575,2745,3234,2549,1525,45,57,45057,5991,8800,11387,8312,5576,9176,12456,10543,11567,17976,23843,18855,92308,44504,47804,68565,19412,1212,722,4968,58849,17787,38938.0,49868.0
2371,"Dorchester County, South Carolina",77077,4839,5532,3530,4777,5816,5302,3407,45,35,45035,12063,15872,19632,9574,11773,16644,21713,11790,23836,32516,41345,21364,158299,77077,81222,106779,39720,2866,2930,8516,63080,27941,62567.0,77278.0
2372,"Florence County, South Carolina",64765,4191,5020,2887,4311,4601,4798,2673,45,41,45041,10092,11887,16666,9529,11153,13622,19444,13108,21245,25509,36110,22637,138475,64765,73710,74278,59193,1810,795,3657,47058,22954,57931.0,64495.0
2373,"Laurens County, South Carolina",32545,2127,1967,1371,1721,1873,2202,1117,45,59,45059,5176,5409,8890,5280,5237,5893,9545,6713,10413,11302,18435,11993,66846,32545,34301,46860,16083,317,1530,3263,43304,9896,26566.0,30488.0
2374,"McCormick County, South Carolina",5284,227,160,168,58,121,166,100,45,65,45065,642,890,1492,1542,364,492,1305,1641,1006,1382,2797,3183,9531,5284,4247,4908,4271,23,44,79,43633,1529,5216.0,5697.0
2375,"Pickens County, South Carolina",61734,3234,3459,2135,3006,3039,3410,2032,45,77,45077,16102,9898,14700,8910,14343,9832,15545,11088,30445,19730,30245,19998,124029,61734,62295,109519,8440,2483,1209,4557,49573,21316,49049.0,57546.0
2376,"Union County, South Carolina",13099,766,888,583,779,761,804,495,45,87,45087,1858,2093,3797,2291,1917,2373,4159,3103,3775,4466,7956,5394,27490,13099,14391,18017,8441,4,63,427,41186,3934,12092.0,13257.0
2377,"Williamsburg County, South Carolina",14942,781,954,611,847,893,973,637,45,89,45089,2317,2703,3977,2667,2163,2546,4723,3600,4480,5249,8700,6267,31324,14942,16382,9957,20217,213,484,709,32485,3765,15054.0,15985.0
2378,"Aurora County, South Dakota",1461,78,109,96,123,41,118,63,46,3,46003,210,263,340,255,166,181,342,268,376,444,682,523,2763,1461,1302,2548,46,0,66,202,64083,555,1407.0,1405.0
2379,"Grant County, South Dakota",3750,217,254,160,192,244,154,127,46,51,46051,545,604,1074,671,360,600,926,796,905,1204,2000,1467,7149,3750,3399,6688,33,8,260,325,58158,1529,3564.0,3745.0
2380,"Tripp County, South Dakota",2768,165,202,108,153,140,201,101,46,123,46123,345,445,796,520,287,390,724,694,632,835,1520,1214,5458,2768,2690,4426,0,44,0,11,57720,1285,2630.0,2696.0
2381,"Ziebach County, South Dakota",1375,95,114,80,84,128,170,85,46,137,46137,253,285,334,124,191,287,333,138,444,572,667,262,2791,1375,1416,657,0,17,4,9,37400,370,767.0,906.0
2382,"Spink County, South Dakota",3238,185,181,209,206,205,186,142,46,115,46115,381,486,924,612,399,520,873,714,780,1006,1797,1326,6483,3238,3245,6260,14,0,21,201,54423,1328,2951.0,3163.0
2383,"Bon Homme County, South Dakota",4064,179,197,128,154,197,189,108,46,9,46009,746,884,1086,658,301,375,776,765,1047,1259,1862,1423,6929,4064,2865,6134,102,28,40,189,54737,1498,2974.0,3001.0
2384,"Brookings County, South Dakota",17697,1067,942,518,1109,990,938,547,46,11,46011,6124,2940,3243,1916,5540,2474,3171,2135,11664,5414,6414,4051,34601,17697,16904,31987,497,1060,178,1063,58136,6586,12680.0,14567.0
2385,"Fall River County, South Dakota",3398,182,171,138,105,174,108,100,46,47,46047,435,412,962,918,276,450,1192,944,711,862,2154,1862,6747,3398,3349,5873,0,105,52,272,50588,1682,3563.0,4042.0
2386,"Hamlin County, South Dakota",3073,295,220,157,266,198,307,151,46,57,46057,424,504,719,449,395,471,663,501,819,975,1382,950,6025,3073,2952,5825,26,24,55,259,67105,1318,2762.0,3083.0
2387,"Jackson County, South Dakota",1631,181,139,88,177,159,140,64,46,71,46071,220,250,430,232,303,257,321,238,523,507,751,470,3290,1631,1659,1282,10,14,4,9,33295,508,1095.0,1115.0
2388,"Custer County, South Dakota",4233,169,236,154,178,193,211,109,46,33,46033,354,539,1367,1276,398,633,1513,1251,752,1172,2880,2527,8719,4233,4486,8131,22,30,16,336,58522,1948,4721.0,5494.0
2389,"Hyde County, South Dakota",685,37,52,23,40,24,22,22,46,69,46069,71,106,216,147,46,77,205,198,117,183,421,345,1319,685,634,1166,32,0,3,9,57788,368,690.0,710.0
2390,"Faulk County, South Dakota",1168,105,91,31,79,55,50,39,46,49,46049,120,196,336,224,108,146,274,393,228,342,610,617,2312,1168,1144,2229,1,0,0,8,55096,635,1118.0,1182.0
2391,"Hutchinson County, South Dakota",3559,293,242,129,331,205,251,126,46,67,46067,421,549,969,717,431,549,884,972,852,1098,1853,1689,7308,3559,3749,7055,0,21,2,158,57089,1587,3365.0,3767.0
2392,"Walworth County, South Dakota",2714,139,193,109,190,211,144,83,46,129,46129,306,490,678,610,293,472,653,697,599,962,1331,1307,5457,2714,2743,4370,275,0,39,120,55583,1267,2477.0,2580.0
2393,"Buffalo County, South Dakota",1008,116,104,84,114,103,78,68,46,17,46017,168,169,189,78,181,200,206,68,349,369,395,146,2026,1008,1018,282,3,0,0,84,34808,92,490.0,549.0
2394,"Day County, South Dakota",2843,133,196,122,160,164,109,132,46,37,46037,332,419,780,649,286,343,693,756,618,762,1473,1405,5486,2843,2643,4765,5,7,23,124,46679,1131,2747.0,2964.0
2395,"Douglas County, South Dakota",1435,90,108,81,115,86,117,52,46,43,46043,163,189,416,316,170,170,412,372,333,359,828,688,2929,1435,1494,2782,0,0,1,19,58684,546,1605.0,1707.0
2396,"Harding County, South Dakota",681,27,45,32,43,52,18,51,46,63,46063,91,144,190,120,85,83,184,109,176,227,374,229,1306,681,625,1219,27,0,9,31,59655,291,770.0,813.0
2397,"McPherson County, South Dakota",1090,61,53,29,107,66,77,29,46,89,46089,143,135,316,283,113,158,263,394,256,293,579,677,2297,1090,1207,2213,48,18,0,30,44574,402,1137.0,1324.0
2398,"Roberts County, South Dakota",5267,419,355,243,372,380,384,193,46,109,46109,776,742,1315,969,714,735,1215,1027,1490,1477,2530,1996,10287,5267,5020,5932,62,11,91,357,50348,1696,3889.0,4307.0
2399,"Sully County, South Dakota",669,37,44,7,26,47,38,38,46,119,46119,60,86,199,177,74,99,171,143,134,185,370,320,1305,669,636,1253,0,0,0,17,62153,292,861.0,930.0
2400,"Lincoln County, South Dakota",28154,2170,2475,1173,2053,2447,2134,1142,46,83,46083,3883,6499,6359,3146,4244,6465,6406,3781,8127,12964,12765,6927,56826,28154,28672,53679,756,627,266,1212,82473,11340,25231.0,32455.0
2401,"Lake County, South Dakota",6661,323,303,214,428,291,372,198,46,79,46079,1188,1049,1729,1369,797,878,1788,1304,1985,1927,3517,2673,12717,6661,6056,11930,52,208,40,140,61846,2867,6786.0,5873.0
2402,"Lawrence County, South Dakota",12659,564,669,427,497,564,804,365,46,81,46081,2384,2128,3368,2504,2390,1975,3358,2866,4774,4103,6726,5370,25478,12659,12819,23732,230,255,58,831,52641,5827,11842.0,13828.0
2403,"Codington County, South Dakota",14135,911,1112,574,823,1003,896,502,46,29,46029,2178,2645,3709,2148,2024,2447,3596,2600,4202,5092,7305,4748,28026,14135,13891,26425,219,151,2,657,56376,5826,11669.0,13161.0
2404,"Butte County, South Dakota",5213,297,390,243,307,381,293,191,46,19,46019,725,847,1326,962,591,803,1373,1073,1316,1650,2699,2035,10225,5213,5012,9579,68,12,48,371,46508,2207,4351.0,4802.0
2405,"Corson County, South Dakota",2097,219,172,120,221,188,226,103,46,31,46031,307,335,469,212,309,326,439,241,616,661,908,453,4150,2097,2053,1202,14,1,3,19,35759,516,1175.0,1283.0
2406,"Edmunds County, South Dakota",1969,112,141,80,139,211,106,73,46,45,46045,276,282,553,418,223,303,547,338,499,585,1100,756,3909,1969,1940,3819,7,2,26,96,71324,963,1918.0,1985.0
2407,"Campbell County, South Dakota",805,61,50,31,24,45,22,37,46,21,46021,61,102,254,205,68,88,229,167,129,190,483,372,1485,805,680,1460,0,1,0,3,54449,352,831.0,873.0
2408,"Bennett County, South Dakota",1686,176,246,64,160,135,193,105,46,7,46007,307,252,309,185,241,342,350,213,548,594,659,398,3425,1686,1739,1151,2,15,10,95,47500,439,1149.0,1183.0
2409,"Haakon County, South Dakota",1016,74,55,55,58,68,89,63,46,55,46055,110,194,276,164,68,131,266,259,178,325,542,423,2018,1016,1002,1813,1,0,0,13,42250,466,1044.0,1137.0
2410,"Jones County, South Dakota",374,0,8,20,26,47,26,5,46,75,46075,33,63,142,96,33,39,156,87,66,102,298,183,793,374,419,737,9,0,0,0,46149,236,558.0,599.0
2411,"Meade County, South Dakota",14409,880,1041,507,715,958,986,428,46,93,46093,2860,2859,3405,1939,1992,2618,3366,2245,4852,5477,6771,4184,27717,14409,13308,25138,525,339,193,1176,60578,5394,11621.0,13670.0
2412,"Turner County, South Dakota",4148,278,290,174,246,269,286,156,46,125,46125,452,740,1143,779,455,727,1086,927,907,1467,2229,1706,8300,4148,4152,8094,38,24,16,203,59242,1767,4150.0,4548.0
2413,"Brown County, South Dakota",19166,1258,1311,765,1160,1359,1247,775,46,13,46013,3418,3488,4795,2864,3380,3229,4817,3782,6798,6717,9612,6646,38915,19166,19749,34768,923,1217,54,1143,58216,8119,16114.0,17547.0
2414,"Hanson County, South Dakota",1702,125,126,94,149,118,176,86,46,61,46061,205,283,425,258,210,296,413,249,415,579,838,507,3399,1702,1697,3383,0,0,0,0,64696,681,2006.0,2388.0
2415,"McCook County, South Dakota",2776,234,263,109,196,211,195,146,46,87,46087,352,472,724,457,299,472,670,583,651,944,1394,1040,5548,2776,2772,5324,39,0,73,225,61507,1195,2587.0,2900.0
2416,"Mellette County, South Dakota",1020,81,104,37,84,105,140,22,46,95,46095,157,161,257,144,124,159,232,166,281,320,489,310,2052,1020,1032,795,3,0,0,91,30650,303,683.0,769.0
2417,"Moody County, South Dakota",3271,200,251,158,229,266,196,117,46,101,46101,425,525,902,558,383,529,838,678,808,1054,1740,1236,6507,3271,3236,5180,33,138,15,288,61538,1265,2933.0,3206.0
2418,"Pennington County, South Dakota",55795,3761,3866,2207,3599,3373,3512,1949,46,103,46103,9109,10229,14095,9029,7868,9968,14445,10176,16977,20197,28540,19205,110685,55795,54890,91710,1336,1425,564,5730,57039,22355,47743.0,57518.0
2419,"Union County, South Dakota",7718,463,492,314,432,421,602,374,46,127,46127,1019,1454,2083,1268,890,1477,2048,1406,1909,2931,4131,2674,15368,7718,7650,14404,124,194,147,490,70378,3207,7897.0,8864.0
2420,"Miner County, South Dakota",1125,35,100,55,68,84,71,43,46,97,46097,125,192,318,205,99,173,315,233,224,365,633,438,2211,1125,1086,2130,6,8,14,45,52910,441,1064.0,1138.0
2421,"Asotin County, Washington",10868,600,406,409,519,672,830,349,53,3,53003,1422,1914,2919,2407,1389,1899,3180,2715,2811,3813,6099,5122,22421,10868,11553,20731,116,192,210,900,53715,4175,9736.0,11847.0
2422,"Adams County, Washington",9980,958,1059,504,963,910,970,507,53,1,53001,1706,1776,1926,1027,1550,1649,1954,1111,3256,3425,3880,2138,19594,9980,9614,12761,203,154,5234,12458,48294,1838,4644.0,5109.0
2423,"Garfield County, Washington",1139,67,65,65,45,60,42,101,53,23,53023,113,130,319,290,78,215,289,261,191,345,608,551,2230,1139,1091,2037,0,71,0,42,55900,435,1246.0,1478.0
2424,"Mason County, Washington",33063,1754,2055,1097,1597,1538,1718,967,53,45,53045,4719,5792,9052,6901,3501,5045,8893,7482,8220,10837,17945,14383,63804,33063,30741,53269,800,752,3398,6365,57634,11498,28073.0,36572.0
2425,"Skagit County, Washington",62106,3904,3941,2355,3677,3457,4202,2232,53,57,53057,9134,11340,15758,11823,8679,11019,16612,13628,17813,22359,32370,25451,125612,62106,63506,103131,1110,2388,11431,23097,67028,22840,55968.0,47259.0
2426,"Stevens County, Washington",22242,1262,1545,945,1124,1247,1430,817,53,65,53065,2584,3190,6534,4959,2540,3334,6822,5099,5124,6524,13356,10058,44655,22242,22413,39788,192,290,390,1658,51775,8449,22677.0,21581.0
2427,"Spokane County, Washington",250722,15889,15713,9815,14909,14147,16359,9067,53,63,53063,45022,49280,62589,35985,42768,47966,65711,43856,87790,97246,128300,79841,505505,250722,254783,443791,8444,11553,7889,28970,56904,97124,227246.0,291049.0
2428,"Lincoln County, Washington",5345,278,293,231,254,263,374,200,53,43,53043,551,788,1496,1338,531,750,1494,1363,1082,1538,2990,2701,10574,5345,5229,9881,83,69,81,357,54631,2000,5713.0,6942.0
2429,"Chelan County, Washington",38219,2381,3002,1668,2277,2653,2213,1454,53,7,53007,5744,6731,9631,6616,5221,6663,9968,7561,10965,13394,19599,14177,76229,38219,38010,61268,492,615,10282,21297,58795,12797,33380.0,42548.0
2430,"Jefferson County, Washington",15276,401,516,332,543,770,410,310,53,31,53031,1541,2058,4386,5418,1334,1822,5200,5620,2875,3880,9586,11038,31285,15276,16009,28425,178,516,289,1147,55127,8917,20276.0,23580.0
2431,"Kitsap County, Washington",135983,7920,7917,4693,7433,7197,7570,4449,53,35,53035,27058,25538,33988,21398,19593,23466,35445,24746,46651,49004,69433,46144,265882,135983,129899,215015,7129,12876,5881,20652,75411,52587,124317.0,155853.0
2432,"King County, Washington",1100652,65551,66118,36175,62776,63758,58200,34967,53,33,53033,195043,270597,280451,126168,183916,254611,278458,158164,378959,525208,558909,284332,2195502,1100652,1094850,1404324,141790,386404,92377,212241,94974,602547,998499.0,1178868.0
2433,"Pacific County, Washington",10911,504,435,354,414,587,418,226,53,49,53049,1212,1614,2955,3245,1107,1480,3225,3320,2319,3094,6180,6565,21688,10911,10777,18907,76,365,886,2122,46733,4181,10716.0,14011.0
2434,"Pend Oreille County, Washington",6742,291,295,267,314,307,355,305,53,51,53051,698,989,2045,1727,674,883,2092,1705,1372,1872,4137,3432,13377,6742,6635,12021,49,130,299,515,50591,2551,6802.0,8422.0
2435,"San Juan County, Washington",8089,227,281,241,252,329,329,201,53,55,53055,729,1125,2454,2670,739,1260,2732,2857,1468,2385,5186,5527,16788,8089,8699,15497,149,219,303,1082,63622,4669,10774.0,12977.0
2436,"Skamania County, Washington",5900,289,359,218,220,248,390,205,53,59,53059,619,1054,1873,1176,599,1050,1978,1163,1218,2104,3851,2339,11753,5900,5853,10911,58,131,151,745,65181,2494,5639.0,6918.0
2437,"Whitman County, Washington",25175,1089,1161,610,1001,918,1040,515,53,75,53075,11178,3715,3964,2342,10546,3323,4054,2659,21724,7038,8018,5001,49231,25175,24056,40573,1084,4169,799,3106,42745,9259,17305.0,16653.0
2438,"Yakima County, Washington",125044,10569,10786,6091,9735,10388,10222,5863,53,77,53077,21244,22806,27262,15597,20176,22536,27592,18141,41420,45342,54854,33738,249697,125044,124653,192911,2918,2447,32869,123069,51637,32569,77750.0,65221.0
2439,"Clallam County, Washington",37128,1893,1684,1136,1652,1902,1701,1151,53,9,53009,4734,6066,9610,10143,4023,5497,10766,11572,8757,11563,20376,21715,75392,37128,38264,66144,825,1284,513,4781,52192,15485,39457.0,43697.0
2440,"Cowlitz County, Washington",52844,3222,3048,2122,3213,3410,3400,2123,53,15,53015,7452,9321,14369,9392,7385,9224,14489,10690,14837,18545,28858,20082,106778,52844,53934,94987,847,1365,1737,9583,54506,17755,45692.0,59164.0
2441,"Ferry County, Washington",3821,164,198,116,147,149,204,110,53,19,53019,511,573,1083,1004,382,633,1208,924,893,1206,2291,1928,7578,3821,3757,5789,11,53,57,359,41939,1446,3601.0,4308.0
2442,"Lewis County, Washington",39083,2380,2339,1591,2206,1978,2514,1500,53,41,53041,5526,6829,10293,7775,4939,6734,10780,8411,10465,13563,21073,16186,78145,39083,39062,70251,414,1024,1614,8000,53484,13465,34149.0,44735.0
2443,"Douglas County, Washington",21107,1427,1808,922,1324,1774,1387,922,53,17,53017,3179,3857,5159,3328,2722,3803,5083,3901,5901,7660,10242,7229,42023,21107,20916,29137,203,305,10555,13281,62951,6237,15543.0,20567.0
2444,"Island County, Washington",41393,2342,2064,1297,2307,1811,2207,1095,53,29,53029,7608,6914,9847,9298,5915,6578,11010,10550,13523,13492,20857,19848,82866,41393,41473,70072,2603,4046,1114,6413,68604,17112,42876.0,53089.0
2445,"Pierce County, Washington",437477,30084,31004,16875,28486,28490,27437,16336,53,53,53053,81018,89943,108208,52943,71168,90039,111917,65663,152186,179982,220125,118606,877013,437477,439536,639612,59213,55571,26090,95327,72113,160245,348485.0,453965.0
2446,"Franklin County, Washington",47702,4277,4358,2362,4076,4263,4322,2202,53,21,53021,8121,10684,9546,4047,7361,9346,8494,4243,15482,20030,18040,8290,92009,47702,44307,64838,2068,2016,17309,48843,63584,10637,23720.0,31330.0
2447,"Walla Walla County, Washington",30904,1732,1826,1129,1598,1534,1924,1123,53,71,53071,6375,5673,7484,4784,5459,4724,7247,5852,11834,10397,14731,10636,60365,30904,29461,50534,1074,999,4499,12874,57858,9642,25419.0,23379.0
2448,"Whatcom County, Washington",109070,6076,6176,3614,5737,5981,5709,3625,53,73,53073,23545,20093,26010,17222,23492,19789,27319,20099,47037,39882,53329,37321,220821,109070,111751,184006,2204,9120,8058,20805,62984,44349,109673.0,137032.0
2449,"Grant County, West Virginia",5800,288,312,218,299,238,380,186,54,23,54023,819,899,1655,1337,736,898,1638,1441,1555,1797,3293,2778,11616,5800,5816,11262,181,23,39,86,42216,2614,4956.0,5497.0
2450,"Hampshire County, West Virginia",11874,537,747,446,573,596,537,425,54,27,54027,1515,1835,3651,2528,1402,1850,3507,2545,2917,3685,7158,5073,23309,11874,11435,22627,258,104,10,340,47857,5330,8608.0,9872.0
2451,"Brooke County, West Virginia",11089,487,581,369,490,483,539,386,54,9,54009,1828,1746,3211,2272,1632,1694,3294,2852,3460,3440,6505,5124,22459,11089,11370,21620,392,108,41,201,51496,5063,9613.0,10631.0
2452,"Doddridge County, West Virginia",4739,151,209,166,177,187,141,128,54,17,54017,867,899,1375,889,488,662,1165,873,1355,1561,2540,1762,8560,4739,3821,8178,137,45,8,49,45545,1971,2840.0,3069.0
2453,"Hardy County, West Virginia",7122,421,515,274,325,401,303,253,54,31,54031,767,1144,2105,1549,769,1174,1988,1470,1536,2318,4093,3019,13805,7122,6683,12618,768,227,2,216,47438,3137,5643.0,6287.0
2454,"Marion County, West Virginia",27767,1718,1722,1004,1528,1464,1563,872,54,49,54049,4960,4943,7199,4803,4862,4829,7503,5967,9822,9772,14702,10770,56355,27767,28588,52748,1975,268,358,733,50305,12439,23029.0,25704.0
2455,"Mingo County, West Virginia",11851,735,656,574,719,574,829,438,54,59,54059,1535,2108,3326,2021,1547,2256,3689,2387,3082,4364,7015,4408,24290,11851,12439,23258,568,19,158,0,32764,5053,9510.0,9987.0
2456,"Hancock County, West Virginia",14178,715,684,503,688,767,774,558,54,29,54029,1880,2343,4247,2879,1670,2377,4618,3753,3550,4720,8865,6632,29383,14178,15205,27901,578,136,0,460,45763,6140,12702.0,13546.0
2457,"Marshall County, West Virginia",15516,821,902,531,769,636,1106,536,54,51,54051,2108,2771,4552,3002,1904,2460,4676,3705,4012,5231,9228,6707,31308,15516,15792,30512,270,79,17,312,48557,7572,13216.0,13666.0
2458,"Nicholas County, West Virginia",12358,638,829,424,642,767,683,416,54,67,54067,1540,2126,3435,2656,1552,2160,3696,2804,3092,4286,7131,5460,25078,12358,12720,24351,214,56,121,205,40086,6507,9491.0,10570.0
2459,"Tucker County, West Virginia",3512,168,77,151,148,140,152,93,54,93,54093,461,539,1058,867,409,552,1079,897,870,1091,2137,1764,6982,3512,3470,6799,33,38,24,24,49118,1939,3475.0,3830.0
2460,"Tyler County, West Virginia",4394,248,254,161,199,210,283,153,54,95,54095,546,683,1358,917,561,669,1340,1002,1107,1352,2698,1919,8811,4394,4417,8602,32,62,17,31,43087,2314,3654.0,3873.0
2461,"Roane County, West Virginia",6923,322,333,275,349,398,472,302,54,87,54087,843,1141,2057,1408,772,1158,2071,1575,1615,2299,4128,2983,14020,6923,7097,13723,9,22,23,160,37373,2921,5247.0,5745.0
2462,"Taylor County, West Virginia",8490,438,433,290,446,438,504,292,54,91,54091,1124,1622,2439,1561,1008,1481,2433,1772,2132,3103,4872,3333,16864,8490,8374,16245,218,52,117,171,48578,4392,6538.0,7334.0
2463,"Wood County, West Virginia",41052,2381,2285,1622,2454,2137,2848,1502,54,107,54107,5689,7247,11614,7503,5668,7536,12322,9441,11357,14783,23936,16944,84960,41052,43908,81720,1208,445,95,978,47321,17539,35615.0,38487.0
2464,"Gilmer County, West Virginia",4725,260,217,136,126,162,160,48,54,21,54021,1056,1151,1178,628,756,476,884,704,1812,1627,2062,1332,8041,4725,3316,6694,966,75,131,330,42636,1834,2543.0,2639.0
2465,"Mason County, West Virginia",13022,836,846,558,652,829,725,453,54,53,54053,1668,2120,3692,2467,1680,2525,3932,3002,3348,4645,7624,5469,26820,13022,13798,26092,112,172,40,194,46078,6007,10186.0,11149.0
2466,"Monroe County, West Virginia",6657,316,349,269,298,389,369,223,54,63,54063,750,1146,1901,1514,765,1010,1887,1803,1515,2156,3788,3317,13401,6657,6744,13027,125,0,0,124,38540,3417,5805.0,6417.0
2467,"Pleasants County, West Virginia",4045,180,153,195,159,192,165,173,54,73,54073,639,791,1180,665,415,567,1038,728,1054,1358,2218,1393,7482,4045,3437,7196,21,0,195,220,56838,1699,3150.0,3467.0
2468,"Cabell County, West Virginia",46172,2805,2432,1607,2476,2614,2392,1491,54,11,54011,9249,8459,11346,7404,9431,8283,11684,9796,18680,16742,23030,17200,94339,46172,48167,85501,4587,1283,566,1324,40028,19971,33085.0,36795.0
2469,"Jefferson County, West Virginia",27972,1654,1754,1165,1450,1711,1853,1109,54,37,54037,3880,5191,8288,4049,3856,5427,8396,4732,7736,10618,16684,8781,56506,27972,28534,49263,3504,769,1083,3242,80430,12212,24147.0,27163.0
2470,"Logan County, West Virginia",16437,927,811,597,953,648,1162,570,54,45,54045,2291,3141,4702,2847,2009,3018,4774,3583,4300,6159,9476,6430,33154,16437,16717,32050,584,29,30,311,36168,6826,12359.0,12981.0
2471,"Pendleton County, West Virginia",3585,169,148,166,146,178,194,74,54,71,54071,413,522,1081,882,363,458,1033,970,776,980,2114,1852,7001,3585,3416,6689,233,0,24,57,42312,1884,3225.0,3646.0
2472,"Harrison County, West Virginia",33109,1944,1982,1264,1943,1818,2142,1226,54,33,54033,4480,6246,9375,5591,4533,6314,9539,7284,9013,12560,18914,12875,67908,33109,34799,64720,1069,396,207,1123,53022,15197,27960.0,30375.0
2473,"Ohio County, West Virginia",20307,1125,1083,683,1048,995,1220,744,54,69,54069,3389,3569,5497,3795,3371,3425,5905,5128,6760,6994,11402,8923,42143,20307,21836,39166,1641,300,136,487,50584,9720,17938.0,19674.0
2474,"Calhoun County, West Virginia",3523,158,236,74,194,137,346,148,54,13,54013,384,583,1102,842,383,586,1104,874,767,1169,2206,1716,7295,3523,3772,7223,3,0,0,136,38382,1689,2617.0,2948.0
2475,"Morgan County, West Virginia",8755,365,387,326,438,376,545,313,54,65,54065,1113,1349,2820,1876,1048,1355,2722,2157,2161,2704,5542,4033,17709,8755,8954,16914,193,0,64,69,51745,3932,7654.0,8257.0
2476,"Raleigh County, West Virginia",37679,2164,2081,1332,1845,2319,2209,1221,54,81,54081,5490,7476,9843,6786,4926,6720,10042,8291,10416,14196,19885,15077,75252,37679,37573,66312,5816,731,631,1235,43748,15246,29618.0,32640.0
2477,"Putnam County, West Virginia",27875,1558,1827,1239,1516,1694,1793,1153,54,79,54079,3565,5371,7786,4560,3366,5642,8006,5565,6931,11013,15792,10125,56610,27875,28735,54592,801,438,68,662,60097,12456,24893.0,28410.0
2478,"Barbour County, West Virginia",8170,446,497,342,407,349,583,264,54,1,54001,1448,1285,2184,1524,1490,1381,2287,1702,2938,2666,4471,3226,16633,8170,8463,15939,146,128,48,155,38459,3599,6054.0,6634.0
2479,"McDowell County, West Virginia",9595,558,514,348,469,574,437,307,54,47,54047,1241,1826,2702,1785,1019,1420,2750,2090,2260,3246,5452,3875,18661,9595,9066,16628,1551,13,181,271,27682,3208,6203.0,6494.0
2480,"Wayne County, West Virginia",19608,1035,1076,788,1040,1208,1196,776,54,99,54099,2750,3381,5497,3780,2594,3563,5887,4431,5344,6944,11384,8211,40303,19608,20695,39330,347,113,154,264,37988,8286,15182.0,16735.0
2481,"Jackson County, West Virginia",14345,822,1073,599,732,885,804,519,54,35,54035,1902,2573,4000,2589,1756,2503,4188,3175,3658,5076,8188,5764,28907,14345,14562,28219,109,97,20,197,47837,6772,12187.0,13429.0
2482,"Mercer County, West Virginia",28419,1764,2016,1019,1662,1900,1455,1075,54,55,54055,4354,4782,7502,5577,4491,5255,8465,7197,8845,10037,15967,12774,59919,28419,31500,54664,3838,362,32,706,40784,12713,22982.0,25103.0
2483,"Upshur County, West Virginia",12201,700,619,468,633,804,621,396,54,97,54097,2151,1986,3190,2288,2082,1926,3284,2555,4233,3912,6474,4843,24502,12201,12301,23741,500,43,32,334,40322,5953,9218.0,10161.0
2484,"Webster County, West Virginia",4171,212,140,145,202,321,148,166,54,101,54101,511,657,1243,912,469,652,1262,995,980,1309,2505,1907,8386,4171,4215,8352,2,0,5,5,34927,1858,2978.0,3378.0
2485,"Berkeley County, West Virginia",56868,3641,3832,2294,3506,3927,3690,2311,54,3,54003,8318,11537,15612,7705,8518,11749,15799,8961,16836,23286,31411,16666,115329,56868,58461,100097,9039,1242,1404,5078,62515,23591,42850.0,49146.0
2486,"Fayette County, West Virginia",21916,1233,1158,804,1266,1380,1111,679,54,19,54019,3027,3997,6318,4001,2546,3679,6098,4901,5573,7676,12416,8902,43576,21916,21660,40722,2274,24,42,505,41394,9339,15337.0,16794.0
2487,"Iron County, Wisconsin",2891,89,120,73,67,100,150,74,55,51,55051,278,388,981,837,246,377,906,876,524,765,1887,1713,5687,2891,2796,5492,7,28,4,78,43798,1147,3497.0,4031.0
2488,"Clark County, Wisconsin",17489,1456,1407,880,1382,1416,1367,835,55,19,55019,2270,2803,4597,2635,2109,2626,4324,3031,4379,5429,8921,5666,34579,17489,17090,33359,164,138,332,1622,54012,6164,13596.0,14873.0
2489,"St. Croix County, Wisconsin",44328,2814,3192,2021,2630,3083,3233,1978,55,109,55109,5550,9026,12704,5623,5516,8986,12572,6406,11066,18012,25276,12029,88732,44328,44404,85085,710,869,305,2134,84756,19005,47508.0,56701.0
2490,"Oconto County, Wisconsin",19189,990,1050,707,867,1041,1119,678,55,83,55083,2124,3171,6269,3718,2022,3032,5843,3855,4146,6203,12112,7573,37646,19189,18457,36251,173,146,66,673,60908,8662,19978.0,23214.0
2491,"Lincoln County, Wisconsin",13922,602,647,639,636,646,765,471,55,69,55069,1714,2272,4571,2717,1532,2226,4445,3101,3246,4498,9016,5818,27744,13922,13822,26854,204,109,8,439,58541,6007,14706.0,16531.0
2492,"Waupaca County, Wisconsin",26237,1265,1462,1089,1159,1401,1485,922,55,135,55135,3237,4410,7938,5091,2986,4214,7481,5360,6223,8624,15419,10451,51245,26237,25008,49301,347,224,516,1606,58693,11676,26024.0,29118.0
2493,"Barron County, Wisconsin",22554,1225,1369,836,1211,1313,1468,784,55,5,55005,2843,3915,6326,4454,2703,3655,6311,5230,5546,7570,12637,9684,45229,22554,22675,42809,718,314,493,1129,52703,9864,22643.0,25345.0
2494,"Sawyer County, Wisconsin",8356,381,467,316,350,464,517,245,55,113,55113,926,1180,2553,2072,775,1106,2517,2069,1701,2286,5070,4141,16399,8356,8043,12643,42,103,138,449,47714,3522,9121.0,10479.0
2495,"Green Lake County, Wisconsin",9460,546,594,426,513,584,573,368,55,47,55047,1091,1517,2804,1906,1071,1431,2611,2144,2162,2948,5415,4050,18755,9460,9295,18069,109,137,145,923,55075,4192,9388.0,10663.0
2496,"Price County, Wisconsin",6806,245,297,286,264,285,335,237,55,99,55099,664,989,2307,1635,660,931,2168,1730,1324,1920,4475,3365,13416,6806,6610,12779,112,81,51,238,47956,2925,7577.0,8645.0
2497,"Marquette County, Wisconsin",7798,374,376,276,379,417,399,232,55,77,55077,801,1126,2522,1791,714,1137,2326,1902,1515,2263,4848,3693,15304,7798,7506,14689,104,84,116,520,52288,3487,7893.0,9060.0
2498,"Marinette County, Wisconsin",20316,930,1193,770,891,1024,1077,724,55,75,55075,2386,3213,6325,4429,2169,3043,6206,4941,4555,6256,12531,9370,40391,20316,20075,39045,297,135,42,706,50330,8883,20046.0,22977.0
2499,"Milwaukee County, Wisconsin",460464,33587,32132,18480,32218,31715,30602,17968,55,79,55079,86206,94586,109442,53384,87929,100039,117735,72556,174135,194625,227177,125940,951226,460464,490762,562729,251253,41067,55185,142731,50606,174939,440247.0,458935.0
2500,"Shelby County, Missouri",3025,182,250,151,165,207,189,110,29,205,29205,353,529,803,556,357,482,798,680,710,1011,1601,1236,6013,3025,2988,5765,97,16,39,103,44083,1316,3255.0,3356.0
2501,"Webster County, Missouri",19784,1521,1768,924,1342,1352,1419,814,29,225,29225,2975,3506,4983,2810,2452,3390,4918,3184,5427,6896,9901,5994,38655,19784,18871,36918,392,148,206,801,50560,7522,16743.0,18776.0
2502,"Atchison County, Missouri",2597,137,125,88,121,141,137,93,29,5,29005,315,417,743,604,299,381,737,723,614,798,1480,1327,5229,2597,2632,5103,24,25,13,69,50236,1249,2724.0,2814.0
2503,"Bates County, Missouri",7993,511,478,367,476,610,499,324,29,13,29013,1080,1352,2249,1365,1010,1404,2206,1774,2090,2756,4455,3139,16296,7993,8303,15542,246,47,119,360,47625,3626,8023.0,8435.0
2504,"Benton County, Missouri",9508,429,521,327,398,398,517,298,29,15,29015,937,1144,2859,2849,923,1157,2964,2944,1860,2301,5823,5793,19107,9508,9599,18354,48,16,29,391,40249,4241,9312.0,10478.0
2505,"Carter County, Missouri",3032,176,116,187,202,210,175,137,29,35,29035,376,487,868,557,402,500,839,650,778,987,1707,1207,6147,3032,3115,5964,4,0,0,158,39530,1404,2844.0,2906.0
2506,"Dade County, Missouri",3846,195,227,169,167,209,198,134,29,57,29057,524,591,1040,826,390,575,1126,933,914,1166,2166,1759,7578,3846,3732,7234,27,64,21,162,40399,1609,3951.0,4123.0
2507,"Racine County, Wisconsin",96899,6173,6312,4153,5746,5940,6498,3961,55,101,55101,14605,17542,27226,14077,13384,17646,28021,17507,27989,35188,55247,31584,195602,96899,98703,158201,22297,2523,5374,25637,61336,36563,94133.0,106441.0
2508,"Winnebago County, Wisconsin",85855,4768,4940,3146,4604,4924,4581,2981,55,139,55139,16382,16512,22898,12069,15554,14629,22338,14945,31936,31141,45236,27014,170411,85855,84556,156359,3874,4748,1345,7017,58543,36415,87144.0,94032.0
2509,"Forest County, Wisconsin",4529,266,241,172,260,249,242,134,55,41,55041,653,634,1320,1009,556,645,1335,1045,1209,1279,2655,2054,8995,4529,4466,7215,77,70,30,225,45536,1628,4540.0,5052.0
2510,"Green County, Wisconsin",18354,983,1230,739,925,1021,1370,731,55,45,55045,2260,3326,5492,3070,2284,3235,5366,3610,4544,6561,10858,6680,36896,18354,18542,35479,219,236,405,1127,64502,8274,18985.0,21400.0
2511,"Rusk County, Wisconsin",7074,357,422,266,374,343,458,302,55,107,55107,806,1037,2211,1591,700,998,2126,1757,1506,2035,4337,3348,14132,7074,7058,13602,90,23,31,270,47532,3190,7087.0,7881.0
2512,"Shawano County, Wisconsin",20420,1148,1069,789,1102,1117,1338,795,55,115,55115,2544,3317,6109,3978,2333,3337,5966,4496,4877,6654,12075,8474,40904,20420,20484,36288,164,164,68,1146,56531,9071,19751.0,22878.0
2513,"Langlade County, Wisconsin",9703,440,520,393,497,372,561,317,55,67,55067,1191,1549,2945,2078,1012,1389,2903,2392,2203,2938,5848,4470,19146,9703,9443,18246,240,42,127,378,49491,4467,10132.0,11159.0
2514,"Outagamie County, Wisconsin",92704,6045,6765,3914,5608,6133,5863,3768,55,87,55087,14480,18671,24965,11893,13485,17966,25517,14656,27965,36637,50482,26549,185700,92704,92996,166701,2750,6437,3148,7997,65572,39594,93868.0,108223.0
2515,"Vernon County, Wisconsin",15413,1117,1143,704,991,1062,1131,667,55,123,55123,1812,2402,4285,2775,1689,2347,4279,3054,3501,4749,8564,5829,30633,15413,15220,29816,96,140,120,484,52459,6800,14213.0,15910.0
2516,"Columbia County, Wisconsin",29290,1626,1645,1193,1448,1657,1737,1132,55,21,55021,4059,5593,8619,4651,3452,4984,8116,5317,7511,10577,16735,9968,57133,29290,27843,54254,772,445,485,1941,68005,12137,29771.0,33917.0
2517,"Kewaunee County, Wisconsin",10316,499,499,442,476,614,618,403,55,61,55061,1305,1820,3045,1895,1149,1724,2944,2143,2454,3544,5989,4038,20387,10316,10071,19746,148,62,112,618,66192,4541,10758.0,12071.0
2518,"Brown County, Wisconsin",129618,8541,9573,5314,8329,8975,8220,5209,55,9,55009,21226,25754,34090,16750,20831,24913,34485,20788,42057,50667,68575,37538,261368,129618,131750,222053,6386,8465,9159,22502,62340,53550,128979.0,144011.0
2519,"Eau Claire County, Wisconsin",51280,3112,3075,1800,2767,3005,2550,1714,55,35,55035,11776,9654,11833,7014,12459,9141,11947,8651,24235,18795,23780,15665,103514,51280,52234,95139,1286,4222,178,2572,59476,19926,54885.0,58235.0
2520,"Oneida County, Wisconsin",17793,895,726,519,703,717,905,554,55,85,55085,1998,2622,5620,4349,1863,2438,5706,4702,3861,5060,11326,9051,35381,17793,17588,33995,263,137,121,546,56852,8285,21473.0,24159.0
2521,"Polk County, Wisconsin",21885,1059,1244,844,1087,1246,1356,815,55,95,55095,2571,3698,6729,4190,2394,3540,6588,4527,4965,7238,13317,8717,43438,21885,21553,41854,205,223,138,825,59994,9462,22749.0,26326.0
2522,"Washburn County, Wisconsin",7810,346,384,277,340,393,473,253,55,129,55129,723,1114,2450,1990,723,1153,2495,2048,1446,2267,4945,4038,15688,7810,7878,14934,120,100,10,289,50280,3443,9148.0,10371.0
2523,"Waukesha County, Wisconsin",196972,10493,11700,8865,10068,11489,12719,8130,55,133,55133,25877,35787,58473,32351,25015,35426,60593,40063,50892,71213,119066,72414,400475,196972,203503,369238,6448,14193,3200,18901,87277,98304,239042.0,267957.0
2524,"Walworth County, Wisconsin",51443,2734,2949,2129,2520,2964,3079,1988,55,127,55127,9548,8469,14113,8107,9026,8308,14222,9524,18574,16777,28335,17631,103074,51443,51631,96079,978,977,2167,11431,63776,21297,51324.0,57588.0
2525,"Crawford County, Wisconsin",8459,443,513,334,354,432,450,335,55,23,55023,1182,1348,2389,1791,849,1209,2264,1883,2031,2557,4653,3674,16235,8459,7776,15494,323,101,3,250,50595,3651,7744.0,8698.0
2526,"Juneau County, Wisconsin",14142,672,785,485,683,735,665,473,55,57,55057,1785,2685,4334,2564,1379,1932,3703,2766,3164,4617,8037,5330,26478,14142,12336,24826,608,147,180,817,53490,5635,11732.0,13702.0
2527,"Sauk County, Wisconsin",31929,1947,2212,1315,1841,2240,1757,1221,55,111,55111,4354,6036,8831,5157,3928,5837,8852,6317,8282,11873,17683,11474,63922,31929,31993,60126,528,387,831,3281,59943,13498,31318.0,36249.0
2528,"Washington County, Wisconsin",66936,3567,4285,2833,3574,4308,4212,2849,55,131,55131,8557,12249,20417,10695,7787,11851,20556,12852,16344,24100,40973,23547,134925,66936,67989,127872,1815,1762,1051,4270,77663,30569,78003.0,88254.0
2529,"Chippewa County, Wisconsin",33135,1783,1987,1229,1774,2059,1994,1143,55,17,55017,4463,6721,9511,5239,3683,5551,8618,5935,8146,12272,18129,11174,63892,33135,30757,60684,1017,860,116,1140,59742,14016,31561.0,35945.0
2530,"Dane County, Wisconsin",266443,15610,15191,9244,14942,15143,14842,8829,55,25,55025,59595,56487,62191,31685,56916,54522,65147,39294,116511,111009,127338,70979,536078,266443,269635,449694,27781,31808,7939,34059,73893,131119,310017.0,344745.0
2531,"Douglas County, Wisconsin",21760,1105,1209,781,1029,1138,1271,715,55,31,55031,3274,4010,6262,3736,3164,3952,6209,4057,6438,7962,12471,7793,43295,21760,21535,40205,609,538,107,697,53986,9047,22511.0,24668.0
2532,"Jackson County, Wisconsin",10956,622,548,407,610,532,679,389,55,53,55053,1700,2020,3106,1841,1137,1560,2708,1951,2837,3580,5814,3792,20522,10956,9566,17953,417,87,318,709,53650,4090,9272.0,10187.0
2533,"Iowa County, Wisconsin",11865,686,765,492,657,778,766,456,55,49,55049,1451,2100,3519,2035,1391,1995,3491,2219,2842,4095,7010,4254,23618,11865,11753,22860,213,160,80,424,64124,5465,12260.0,13984.0
2534,"Ozaukee County, Wisconsin",43578,2330,2479,1871,2232,2231,3020,1792,55,89,55089,5984,7396,12731,7676,5712,7336,13328,9368,11696,14732,26059,17044,88597,43578,45019,82886,1093,1859,529,2606,85215,21825,54523.0,61453.0
2535,"Portage County, Wisconsin",35584,1774,1919,1190,1698,1818,1895,1233,55,97,55097,8249,6015,8980,5291,7743,5753,8848,6060,15992,11768,17828,11351,70632,35584,35048,65601,577,2093,1061,2272,58853,15850,38496.0,40601.0
2536,"Rock County, Wisconsin",79875,5150,5232,3446,4700,5325,5041,3342,55,105,55105,12050,14885,21855,11567,11656,15105,22536,14572,23706,29990,44391,26139,162152,79875,82277,141160,7083,2035,6242,14107,57875,32266,76068.0,85348.0
2537,"Taylor County, Wisconsin",10367,564,728,452,580,710,669,404,55,119,55119,1253,1671,3154,1838,1082,1633,2890,1990,2335,3304,6044,3828,20325,10367,9958,19787,57,46,92,422,53020,4444,9484.0,10683.0
2538,"Adams County, Wisconsin",10788,326,414,279,325,353,474,256,55,1,55001,1155,1783,3446,2894,779,1155,3085,2879,1934,2938,6531,5773,20094,10788,9306,18621,552,132,236,791,46369,4447,10164.0,11808.0
2539,"Bayfield County, Wisconsin",7636,311,409,255,312,384,322,237,55,7,55007,743,1021,2480,2045,691,1022,2406,1983,1434,2043,4886,4028,14993,7636,7357,12904,130,72,23,300,56096,3521,9529.0,10885.0
2540,"Monroe County, Wisconsin",23127,1479,1651,1012,1540,1569,1746,969,55,81,55081,2875,4320,6513,3603,2713,4157,6016,3934,5588,8477,12529,7537,45771,23127,22644,42540,835,416,845,2102,59587,9710,19670.0,22564.0
2541,"Wood County, Wisconsin",35993,2116,2111,1416,2039,2290,2188,1278,55,141,55141,4678,6264,10421,6608,4412,6145,10672,8095,9090,12409,21093,14703,73112,35993,37119,68862,513,1491,632,2179,54913,16059,37800.0,41197.0
2542,"Ashland County, Wisconsin",7905,435,530,359,405,425,550,243,55,3,55003,1241,1249,2178,1391,1069,1288,2167,1565,2310,2537,4345,2956,15617,7905,7712,13094,117,73,52,450,42510,2922,8029.0,8744.0
2543,"Florence County, Wisconsin",2247,99,99,87,73,100,95,30,55,37,55037,189,320,793,567,200,262,769,538,389,582,1562,1105,4314,2247,2067,4238,13,0,0,59,52181,1072,2657.0,2939.0
2544,"Jefferson County, Wisconsin",42338,2234,2658,1747,2075,2314,2736,1692,55,55,55055,6528,7945,12141,6417,6183,7717,12153,7493,12711,15662,24294,13910,84701,42338,42363,79705,753,530,1642,5992,66291,18613,43146.0,47967.0
2545,"Campbell County, Wyoming",24089,1754,1973,920,1886,2373,1566,825,56,5,56005,3850,5488,6170,2103,3478,5092,5843,2257,7328,10580,12013,4360,47409,24089,23320,44560,170,246,308,4110,82659,9411,18199.0,19564.0
2546,"Lincoln County, Wyoming",9801,680,714,428,657,865,584,450,56,23,56023,1077,1840,2593,1612,1042,1759,2517,1599,2119,3599,5110,3211,19274,9801,9473,18468,9,54,95,881,66964,3672,8875.0,10498.0
2547,"Natrona County, Wyoming",40342,2835,2465,1637,2549,2748,2562,1541,56,25,56025,6420,8408,10299,5227,6281,7889,10068,6353,12701,16297,20367,11580,80333,40342,39991,75689,940,473,397,6787,62772,15083,33348.0,35196.0
2548,"Converse County, Wyoming",7169,545,598,251,439,448,437,358,56,9,56009,879,1359,1986,1159,904,1170,1851,1145,1783,2529,3837,2304,13921,7169,6752,13308,0,32,41,1128,69647,2896,6654.0,6969.0
2549,"Niobrara County, Wyoming",1091,26,19,61,51,62,63,59,56,27,56027,119,160,307,271,149,298,368,281,268,458,675,552,2422,1091,1331,2277,14,0,3,95,39150,488,1314.0,1308.0
2550,"Sweetwater County, Wyoming",22471,1590,1683,973,1425,1930,1402,866,56,37,56037,3581,4842,5750,2374,3152,4439,5238,2598,6733,9281,10988,4972,43521,22471,21050,40642,502,340,523,6913,74843,8369,17130.0,16489.0
2551,"Warren County, Tennessee",20242,1267,1211,961,1177,1234,1450,751,47,177,47177,2876,3841,5396,3113,2673,3827,5470,3878,5549,7668,10866,6991,40702,20242,20460,37221,862,283,1009,3697,41125,8075,13612.0,16692.0
2552,"Washington County, Tennessee",62285,3349,3602,2077,3102,3103,3931,2047,47,179,47179,11793,11184,16508,10351,12365,11230,17273,12469,24158,22414,33781,22820,127805,62285,65520,116464,5340,2137,756,4386,48334,26927,49750.0,59474.0
2553,"Weakley County, Tennessee",16406,897,972,579,822,757,946,582,47,183,47183,3801,2523,4109,2599,3747,2606,4206,3438,7548,5129,8315,6037,33510,16406,17104,29651,2831,84,291,865,39937,6419,12184.0,13710.0
2554,"Benton County, Tennessee",7937,385,399,260,355,335,459,330,47,5,47005,981,1208,2330,1748,955,1244,2424,2101,1936,2452,4754,3849,16140,7937,8203,15319,487,28,0,392,37512,3502,6328.0,7250.0
2555,"Bledsoe County, Tennessee",8707,548,393,244,295,350,305,228,47,7,47007,1290,1911,2533,1319,716,1058,1840,1337,2006,2969,4373,2656,14836,8707,6129,13343,491,10,93,368,44122,3221,4664.0,5758.0
2556,"Campbell County, Tennessee",19434,1118,1148,730,1096,953,1220,759,47,13,47013,2704,3391,5427,3717,2727,3439,5756,4413,5431,6830,11183,8130,39797,19434,20363,38710,127,170,143,556,39803,7723,12532.0,14929.0
2557,"Cannon County, Tennessee",6999,376,521,269,381,536,354,243,47,15,47015,1082,1234,2028,1150,971,1227,2015,1452,2053,2461,4043,2602,14178,6999,7179,13593,265,4,68,317,55330,3221,5314.0,6562.0
2558,"Houston County, Tennessee",4154,211,263,220,177,301,231,90,47,83,47083,621,689,1091,796,481,659,1159,912,1102,1348,2250,1708,8164,4154,4010,7542,441,14,0,31,42711,1857,3168.0,3681.0
2559,"Maury County, Tennessee",44440,3133,3091,1851,2993,2545,3328,1623,47,119,47119,6516,8836,11724,6306,6667,9169,13232,7979,13183,18005,24956,14285,91976,44440,47536,77153,10571,866,712,5354,57170,17695,35369.0,46670.0
2560,"Polk County, Texas",26465,1327,1419,939,1264,1309,1373,770,48,373,48373,3973,4966,7741,4588,2716,3525,7039,4452,6689,8491,14780,9040,48913,26465,22448,41071,4794,378,813,7471,49279,8719,19852.0,24072.0
2561,"Refugio County, Texas",3439,220,185,155,205,153,372,145,48,391,48391,508,547,905,698,482,559,942,848,990,1106,1847,1546,7145,3439,3706,5766,480,21,555,3604,50076,1131,2948.0,3366.0
2562,"Van Zandt County, Texas",27074,1586,1890,1282,1543,1471,2001,1149,48,467,48467,3545,4520,7266,5134,3523,4653,7775,5914,7068,9173,15041,11048,55103,27074,28029,51331,1543,271,629,6010,54654,9143,21890.0,25753.0
2563,"Caldwell County, Texas",21313,1344,1395,1045,1288,1418,1232,879,48,55,48055,4194,3884,5330,2574,3350,4153,5314,3197,7544,8037,10644,5771,42144,21313,20831,34069,2561,423,4217,21993,54152,5951,12092.0,14775.0
2564,"Wilbarger County, Texas",6266,383,463,254,318,394,502,260,48,487,48487,947,1159,1663,1095,990,1172,1658,1273,1937,2331,3321,2368,12833,6266,6567,10017,1291,121,935,3736,45302,1752,4105.0,4518.0
2565,"Martin County, Texas",2943,276,246,222,184,138,408,70,48,317,48317,449,367,814,358,365,552,664,325,814,919,1478,683,5649,2943,2706,4479,48,4,955,2540,66610,797,1762.0,2160.0
2566,"Linn County, Missouri",5885,362,419,247,365,343,461,249,29,115,29115,849,930,1572,1076,759,982,1658,1411,1608,1912,3230,2487,12113,5885,6228,11739,57,43,19,293,45930,2850,5587.0,5700.0
2567,"Howell County, Missouri",19571,1357,1293,844,1226,1390,1215,864,29,91,29091,2838,3340,4961,3527,2700,3445,5369,4324,5538,6785,10330,7851,40104,19571,20533,38584,90,262,46,855,38357,8049,17455.0,18637.0
2568,"Johnson County, Missouri",27503,1738,1530,999,1678,1500,1626,819,29,101,29101,8156,4699,5572,3147,6806,4486,5830,3434,14962,9185,11402,6581,53682,27503,26179,47758,2326,917,350,2356,55273,10102,21132.0,23134.0
2569,"Laclede County, Missouri",17431,1213,1109,763,1154,1087,1289,684,29,105,29105,2423,2983,4769,2778,2385,3281,4777,3443,4808,6264,9546,6221,35531,17431,18100,33751,205,131,153,872,47257,6591,16051.0,16819.0
2570,"Maries County, Missouri",4447,191,315,177,219,239,249,170,29,125,29125,578,709,1344,920,520,698,1306,955,1098,1407,2650,1875,8803,4447,4356,8513,26,91,5,113,47569,2073,4500.0,4774.0
2571,"Phelps County, Missouri",23373,1258,1382,787,1260,1369,1146,751,29,161,29161,6374,3681,5222,3212,3801,3557,5546,3827,10175,7238,10768,7039,44630,23373,21257,40391,1079,1620,117,1137,44154,7974,18553.0,19531.0
2572,"Platte County, Missouri",49730,3089,3329,2033,3028,3531,3066,2156,29,165,29165,7525,10459,13078,6500,7210,10357,13721,7883,14735,20816,26799,14383,100682,49730,50952,85900,6825,2757,767,6082,80393,23522,48885.0,58523.0
2573,"St. Francois County, Missouri",35826,1846,1849,1240,1745,1693,2216,1246,29,187,29187,6486,7999,9402,4843,4139,5619,8206,5953,10625,13618,17608,10796,66643,35826,30817,61886,2960,344,160,1049,46466,13482,24728.0,27996.0
2574,"St. Louis city, Missouri",149175,10241,7432,4379,9432,7854,7620,4270,29,510,29510,29913,33988,37692,16939,31827,35090,39369,23537,61740,69078,77061,40476,308174,149175,158999,143401,143018,10365,2979,12399,43896,61084,131191.0,131876.0
2575,"Andrew County, Missouri",8740,529,444,414,466,502,628,357,29,3,29003,1212,1512,2453,1481,1045,1544,2423,1798,2257,3056,4876,3279,17503,8740,8763,16686,240,61,28,438,58772,4122,9140.0,9774.0
2576,"Butler County, Missouri",20865,1365,1295,965,1268,1636,1094,824,29,23,29023,3036,3534,5612,3466,2946,3719,5868,4436,5982,7253,11480,7902,42656,20865,21791,38560,2367,325,84,914,39915,7500,17259.0,18165.0
2577,"Carroll County, Missouri",4334,308,331,159,225,202,339,177,29,33,29033,555,715,1179,834,539,744,1179,1042,1094,1459,2358,1876,8781,4334,4447,8394,163,43,19,140,50830,1956,4361.0,4531.0
2578,"Daviess County, Missouri",4170,296,283,192,255,266,315,193,29,61,29061,530,655,1053,830,546,628,1056,866,1076,1283,2109,1696,8295,4170,4125,8055,50,15,23,130,51679,1766,3593.0,3884.0
2579,"Holt County, Missouri",2187,103,129,80,117,129,140,63,29,87,29087,228,353,650,502,232,300,661,603,460,653,1311,1105,4432,2187,2245,4289,47,29,0,47,49524,1072,2355.0,2343.0
2580,"Marion County, Missouri",13856,904,897,621,879,911,1051,591,29,127,29127,2118,2456,3671,2219,2203,2541,3822,2754,4321,4997,7493,4973,28608,13856,14752,26193,1070,185,89,509,48784,6108,12938.0,13370.0
2581,"Osage County, Missouri",7034,399,406,279,391,352,510,273,29,151,29151,1125,1214,1974,1102,875,1104,1839,1237,2000,2318,3813,2339,13615,7034,6581,13497,24,4,20,112,61687,3196,7090.0,7449.0
2582,"Ripley County, Missouri",6749,430,528,286,419,474,370,240,29,181,29181,847,1220,1755,1314,900,1082,1855,1478,1747,2302,3610,2792,13567,6749,6818,13092,94,54,11,197,34971,2749,5524.0,5743.0
2583,"Warren County, Missouri",17144,1121,1027,687,1100,1087,1184,649,29,219,29219,2326,2983,4769,2873,2325,2946,4821,3197,4651,5929,9590,6070,34453,17144,17309,31950,700,213,572,1173,60125,7399,15784.0,18373.0
2584,"Washington County, Missouri",12778,741,684,503,707,856,740,553,29,221,29221,1851,2412,3813,1887,1566,2084,3428,2148,3417,4496,7241,4035,24860,12778,12082,23681,529,53,0,346,41483,4857,9282.0,9972.0
2585,"Christian County, Missouri",41886,2770,3539,2020,2647,3068,3159,1812,29,43,29043,5742,8476,10558,5917,6038,8901,11024,7123,11780,17377,21582,13040,85658,41886,43772,81611,707,484,356,2525,60645,17375,41531.0,46904.0
2586,"DeKalb County, Missouri",7855,286,341,205,285,236,314,158,29,63,29063,1515,2195,2067,981,561,709,1306,1102,2076,2904,3373,2083,12526,7855,4671,10757,1122,75,17,324,55918,3130,4594.0,4842.0
2587,"Harrison County, Missouri",4215,298,259,177,272,354,206,165,29,81,29081,517,734,1053,825,457,654,1097,1071,974,1388,2150,1896,8491,4215,4276,8174,46,17,76,195,42917,1920,3689.0,3825.0
2588,"Lafayette County, Missouri",16270,928,1092,741,853,1007,987,688,29,107,29107,2244,2625,4688,2741,2031,2853,4638,3270,4275,5478,9326,6011,32597,16270,16327,30578,717,174,300,942,58766,7707,15876.0,17083.0
2589,"Adair County, Missouri",12321,778,706,466,542,614,619,381,29,1,29001,3953,1668,2509,1619,4583,1712,2560,2037,8536,3380,5069,3656,25369,12321,13048,23240,680,638,83,622,41929,4616,10226.0,10337.0
2590,"Scotland County, Missouri",2426,216,270,118,192,204,191,107,29,199,29199,361,401,547,397,328,374,579,501,689,775,1126,898,4902,2426,2476,4866,0,0,0,0,50085,864,1968.0,1985.0
2591,"Sullivan County, Missouri",3073,170,150,132,221,179,182,99,29,211,29211,442,530,849,540,382,561,838,712,824,1091,1687,1252,6247,3073,3174,5658,142,6,220,1143,46481,1378,2486.0,2471.0
2592,"Clark County, Missouri",3435,209,271,133,190,224,193,130,29,45,29045,424,553,1015,633,374,550,919,764,798,1103,1934,1397,6779,3435,3344,6598,21,69,0,41,48909,1412,3215.0,3394.0
2593,"Jasper County, Missouri",58563,4131,4156,2563,3979,4092,4235,2445,29,97,29097,9956,11512,14012,7769,9761,11687,14719,10439,19717,23199,28731,18208,119920,58563,61357,108371,2283,1364,1768,9644,48357,23090,48326.0,52515.0
2594,"Lewis County, Missouri",5044,305,259,198,263,224,375,180,29,111,29111,936,766,1304,845,837,791,1256,985,1773,1557,2560,1830,9955,5044,4911,9255,419,0,0,47,45988,2004,4456.0,4607.0
2595,"McDonald County, Missouri",11656,901,842,574,692,667,821,455,29,119,29119,1807,2006,3051,1645,1579,2098,2979,1835,3386,4104,6030,3480,22782,11656,11126,19833,415,343,394,2639,41643,4029,8242.0,9051.0
2596,"Perry County, Missouri",9499,568,739,434,550,629,675,358,29,157,29157,1321,1674,2606,1560,1267,1688,2599,1926,2588,3362,5205,3486,19191,9499,9692,18632,108,230,0,439,55863,4613,8740.0,9429.0
2597,"Polk County, Missouri",15532,978,980,720,961,909,1015,753,29,167,29167,2782,2638,3822,2590,2992,2522,3987,3077,5774,5160,7809,5667,31748,15532,16216,30348,294,78,11,775,45660,6515,13763.0,15059.0
2598,"Ray County, Missouri",11276,637,584,511,685,634,877,446,29,177,29177,1644,1940,3284,1834,1442,1934,3307,2274,3086,3874,6591,4108,22875,11276,11599,21924,308,44,26,564,61957,4955,10869.0,11654.0
2599,"Hill County, Montana",8307,715,738,330,737,563,584,337,30,41,30041,1498,1412,1945,1127,1336,1399,1909,1264,2834,2811,3854,2391,16436,8307,8129,11544,68,71,172,623,49321,2660,6445.0,7167.0
2600,"Chouteau County, Montana",2819,162,191,107,153,267,188,126,30,15,30015,422,456,763,556,371,448,770,590,793,904,1533,1146,5732,2819,2913,4456,14,36,23,151,42298,1228,2603.0,2967.0
2601,"Lincoln County, Montana",9711,437,657,320,404,473,459,441,30,53,30053,960,1261,2960,2749,749,1394,3237,2669,1709,2655,6197,5418,19537,9711,9826,18511,40,79,153,611,40140,4366,9330.0,11564.0
2602,"Park County, Montana",8141,387,284,280,376,415,333,252,30,67,30067,925,1475,2494,1744,1028,1531,2454,1822,1953,3006,4948,3566,16352,8141,8211,15631,73,51,32,505,53068,3866,9359.0,11612.0
2603,"Treasure County, Montana",328,19,17,6,16,10,11,16,30,103,30103,38,18,109,110,37,38,130,82,75,56,239,192,668,328,340,632,0,28,2,4,43047,170,443.0,460.0
2604,"Blaine County, Montana",3350,287,323,192,281,276,261,113,30,5,30005,493,557,780,444,529,583,757,569,1022,1140,1537,1013,6719,3350,3369,3026,27,7,75,238,41279,961,2684.0,3121.0
2605,"Sweet Grass County, Montana",1840,103,75,66,59,85,113,65,30,97,30097,251,218,459,540,178,235,525,570,429,453,984,1110,3670,1840,1830,3534,0,10,0,83,49886,1029,2107.0,2446.0
2606,"Teton County, Montana",2973,184,234,130,215,196,245,108,30,99,30099,361,435,815,658,346,486,795,722,707,921,1610,1380,6086,2973,3113,5746,33,16,49,99,55000,1251,3188.0,3695.0
2607,"Prairie County, Montana",643,19,54,6,34,25,59,35,30,79,30079,49,105,170,187,30,96,167,163,79,201,337,350,1252,643,609,1224,0,10,3,16,43625,307,689.0,744.0
2608,"Glacier County, Montana",6767,633,668,306,624,423,853,273,30,35,30035,1139,1285,1451,729,1049,1212,1639,892,2188,2497,3090,1621,13732,6767,6965,4381,39,6,126,451,36045,2035,5075.0,5630.0
2609,"Fallon County, Montana",1467,116,102,5,64,126,104,97,30,25,30025,212,292,419,208,179,252,319,313,391,544,738,521,2921,1467,1454,2785,1,51,1,58,64545,557,1484.0,1575.0
2610,"Golden Valley County, Montana",370,19,12,8,4,18,19,6,30,37,30037,19,23,160,110,36,47,153,75,55,70,313,185,728,370,358,688,10,0,0,49,43875,191,474.0,503.0
2611,"Silver Bow County, Montana",17613,1161,1043,531,887,968,865,583,30,93,30093,3199,3074,4630,2996,2869,2817,4645,3523,6068,5891,9275,6519,34770,17613,17157,32807,191,263,68,1585,45718,7678,16452.0,18973.0
2612,"Stillwater County, Montana",4713,213,269,188,217,269,362,256,30,95,30095,503,710,1442,1056,427,773,1426,1023,930,1483,2868,2079,9466,4713,4753,9075,8,32,69,374,64645,2149,4873.0,5707.0
2613,"Jefferson County, Montana",6027,211,331,313,258,213,478,329,30,43,30043,680,890,1924,1299,583,865,2015,1149,1263,1755,3939,2448,11917,6027,5890,11220,45,6,122,305,69646,2867,6714.0,8191.0
2614,"Granite County, Montana",1708,90,70,61,33,86,103,86,30,39,30039,141,227,511,512,145,208,489,453,286,435,1000,965,3311,1708,1603,3188,3,2,0,75,49881,858,1777.0,2102.0
2615,"Wheatland County, Montana",1032,85,96,43,46,86,100,29,30,107,30107,122,176,257,200,141,176,300,232,263,352,557,432,2142,1032,1110,2024,0,7,0,67,39655,362,946.0,1068.0
2616,"Madison County, Montana",4294,140,201,114,180,228,146,109,30,57,30057,519,658,1220,1287,364,632,1234,1115,883,1290,2454,2402,8302,4294,4008,7889,16,3,137,372,54107,1958,4778.0,6107.0
2617,"Sheridan County, Montana",1747,137,133,39,95,122,70,38,30,91,30091,198,306,478,382,206,291,489,425,404,597,967,807,3483,1747,1736,3292,0,9,6,132,55521,696,1835.0,2029.0
2618,"Carter County, Montana",683,45,51,14,37,76,9,12,30,11,30011,51,113,221,145,74,101,183,156,125,214,404,301,1331,683,648,1290,0,0,0,1,48000,260,786.0,864.0
2619,"Big Horn County, Montana",6680,568,806,374,590,628,555,324,30,3,30003,1049,985,1443,759,1033,1146,1565,866,2082,2131,3008,1625,13387,6680,6707,4009,4,12,28,852,49859,1566,4237.0,4669.0
2620,"Lake County, Montana",14899,999,1009,632,845,1081,886,599,30,47,30047,1967,2319,3693,3172,1842,2368,4242,3251,3809,4687,7935,6423,30013,14899,15114,20103,89,100,111,1374,48829,6119,13181.0,16617.0
2621,"Lewis and Clark County, Montana",33580,1951,1915,1282,1897,2270,1826,1139,30,49,30049,4738,6401,9186,5772,4620,6337,9715,6421,9358,12738,18901,12193,67805,33580,34225,63568,183,464,342,2255,65791,15408,34478.0,42481.0
2622,"Pondera County, Montana",2974,223,196,124,208,191,205,119,30,73,30073,402,468,786,570,394,473,802,628,796,941,1588,1198,5994,2974,3020,4881,8,6,70,122,51151,1194,2723.0,2994.0
2623,"Yellowstone County, Montana",78348,5117,5594,3168,4887,5101,5543,2793,30,111,30111,12127,15446,19901,11747,11813,15420,20575,14528,23940,30866,40476,26275,159008,78348,80660,143434,1183,1110,1044,8928,61264,34425,69108.0,82217.0
2624,"Missoula County, Montana",58730,2938,3315,1799,2877,2710,3474,1831,30,63,30063,13419,12028,13525,8385,12684,11618,14117,9268,26103,23646,27642,17653,117309,58730,58579,107417,751,2174,452,3841,54062,27335,59203.0,71969.0
2625,"Yoakum County, Texas",4480,538,414,242,252,499,341,212,48,501,48501,787,822,857,467,635,829,859,524,1422,1651,1716,991,8631,4480,4151,8311,38,4,134,5736,70005,1032,2303.0,2633.0
2626,"Hale County, Texas",17635,1198,981,789,1100,1380,1259,816,48,189,48189,3467,3388,4042,2085,2594,2944,3701,2397,6061,6332,7743,4482,33826,17635,16191,29018,1706,104,1207,20109,48384,5105,8858.0,9560.0
2627,"Shelby County, Texas",12585,902,1006,591,905,740,1062,544,48,419,48419,1852,2234,3062,2035,1772,2142,3229,2370,3624,4376,6291,4405,25349,12585,12764,19732,4847,114,281,4644,42522,3970,9086.0,10063.0
2628,"Red River County, Texas",5759,274,262,261,264,258,499,206,48,387,48387,631,1066,1502,1346,791,1048,1717,1629,1422,2114,3219,2975,12171,5759,6412,9642,2039,10,137,886,39142,2004,5161.0,5800.0
2629,"Runnels County, Texas",5160,292,444,243,275,271,368,219,48,399,48399,733,881,1315,968,625,808,1398,1153,1358,1689,2713,2121,10277,5160,5117,9510,309,11,304,3511,44940,1852,3782.0,4262.0
2630,"Sutton County, Texas",2065,217,137,41,113,107,123,76,48,435,48435,301,347,469,358,193,395,419,333,494,742,888,691,3824,2065,1759,2395,3,0,1406,2510,54306,501,1416.0,1557.0
2631,"Tom Green County, Texas",58707,4060,3546,2195,3961,3798,4004,2123,48,451,48451,12759,11345,12416,8037,11018,10835,13740,9800,23777,22180,26156,17837,117986,58707,59279,102396,5015,1524,6171,47064,53903,20807,38479.0,44891.0
2632,"Victoria County, Texas",45075,3289,3098,2004,3202,3330,3107,1896,48,469,48469,7640,8663,10429,6394,7490,8561,11275,8173,15130,17224,21704,14567,92109,45075,47034,80546,5488,1067,2517,43175,56834,15381,31123.0,34205.0
2633,"Wharton County, Texas",20419,1372,1531,993,1464,1119,1869,875,48,481,48481,3234,3578,5034,3098,3054,3728,5228,3821,6288,7306,10262,6919,41577,20419,21158,33504,5944,142,1555,17208,48310,5825,14732.0,16709.0
2634,"Wichita County, Texas",68389,4458,4372,2239,4069,4115,3816,2242,48,485,48485,16585,13166,15301,8149,11635,11306,15130,10894,28220,24472,30431,19043,131596,68389,63207,103920,13623,3109,5064,25258,48650,23090,38119.0,45753.0
2635,"Borden County, Texas",293,36,16,6,64,13,7,18,48,33,48033,22,52,60,82,37,33,63,85,59,85,123,167,613,293,320,598,0,0,0,84,72188,125,365.0,412.0
2636,"Marion County, Texas",4858,166,279,123,275,233,265,199,48,315,48315,554,737,1498,1245,535,745,1560,1347,1089,1482,3058,2592,10017,4858,5159,7292,2294,32,209,415,37662,1711,4238.0,4844.0
2637,"Maverick County, Texas",28973,2712,2564,1595,2739,2360,2408,1542,48,323,48323,6057,5209,5470,2960,5017,5268,6123,3744,11074,10477,11593,6704,58174,28973,29201,54104,280,318,2210,55368,39625,6182,13588.0,15338.0
2638,"Grayson County, Texas",63944,4203,4189,2669,4068,3823,4746,2535,48,181,48181,9820,11348,16553,10295,9729,11695,17826,12648,19549,23043,34379,22943,131014,63944,67070,113326,7182,2080,2417,17577,54815,21973,47416.0,58760.0
2639,"Live Oak County, Texas",6707,407,237,223,253,381,266,205,48,297,48297,1069,1515,1600,1201,713,913,1440,1261,1782,2428,3040,2462,12139,6707,5432,11326,279,173,193,4854,53848,2068,4302.0,5053.0
2640,"Palo Pinto County, Texas",14057,928,1014,576,808,924,868,588,48,363,48363,2052,2360,3565,2582,1989,2408,3932,2966,4041,4768,7497,5548,28540,14057,14483,26133,715,226,794,5674,50154,4976,10270.0,12478.0
2641,"Karnes County, Texas",9147,506,482,247,406,459,380,294,48,255,48255,2154,2348,1959,988,975,1111,1581,1192,3129,3459,3540,2180,15545,9147,6398,11825,1053,161,1866,8506,56127,2562,4198.0,5229.0
2642,"DeWitt County, Texas",10574,627,615,421,700,623,619,379,48,123,48123,1347,2351,2881,1709,1177,1593,2441,2234,2524,3944,5322,3943,20340,10574,9766,13159,1900,4,4788,7192,55357,3240,6844.0,8118.0
2643,"Callahan County, Texas",6899,390,449,284,306,354,540,285,48,59,48059,859,1191,1868,1364,779,1154,2055,1484,1638,2345,3923,2848,13856,6899,6957,13058,126,69,166,1334,48651,2867,5579.0,6826.0
2644,"Cass County, Texas",14496,840,1032,591,868,933,929,615,48,67,48067,1866,2358,3860,2972,1864,2527,4213,3614,3730,4885,8073,6586,30059,14496,15563,23401,5195,166,527,1352,44848,5926,12344.0,13856.0
2645,"Gregg County, Texas",60105,4619,4821,2585,4475,4290,4437,2403,48,183,48183,10511,11292,14101,7871,10017,11651,15319,10746,20528,22943,29420,18617,123443,60105,63338,92086,24707,1586,1296,23100,50180,18489,41749.0,47700.0
2646,"Madison County, Texas",8060,383,382,249,496,392,376,343,48,313,48313,1979,2110,1539,997,886,867,1619,1158,2865,2977,3158,2155,14197,8060,6137,10357,2332,477,631,3290,52664,2563,4289.0,5289.0
2647,"Lubbock County, Texas",150307,10413,9970,5923,10024,9754,10299,5917,48,303,48303,38923,28209,30018,16090,36880,27994,32610,21023,75803,56203,62628,37113,304808,150307,154501,250230,21279,6728,14402,107993,52429,50670,99013.0,120204.0
2648,"Kaufman County, Texas",60806,4529,4903,3054,4349,4612,5018,2914,48,257,48257,8881,12815,15121,6547,8861,13368,15838,8038,17742,26183,30959,14585,123804,60806,62998,100717,14662,1590,3219,26524,70107,20186,41265.0,56435.0
2649,"Kendall County, Texas",21485,1101,1247,1180,1018,1265,1856,915,48,259,48259,2895,3850,5699,3739,2546,3933,6221,4530,5441,7783,11920,8269,43769,21485,22284,39336,253,392,1636,10450,84747,9163,20120.0,26419.0
2650,"Floyd County, Texas",2828,153,184,142,212,207,228,127,48,153,48153,398,550,615,483,417,497,689,598,815,1047,1304,1081,5803,2828,2975,5375,242,10,75,3405,50580,862,1959.0,2035.0
2651,"Bailey County, Texas",3611,198,250,343,260,300,222,276,48,17,48017,475,985,699,449,574,468,853,536,1049,1453,1552,985,7100,3611,3489,5949,46,57,965,4411,52273,1153,1793.0,1854.0
2652,"Chambers County, Texas",20939,1436,1754,1154,1350,1560,1662,946,48,71,48071,2995,4454,5314,2110,3051,4139,5274,2384,6046,8593,10588,4494,41305,20939,20366,36369,2997,465,505,9267,91141,6390,16786.0,21641.0
2653,"Bell County, Texas",173837,14839,13720,7455,14881,13084,12718,7042,48,27,48027,38761,35981,33769,16293,32920,36439,37153,20500,71681,72420,70922,36793,348574,173837,174737,220872,84435,10282,9716,86533,54884,53189,94994.0,125867.0
2654,"Cameron County, Texas",204948,17736,18529,11536,17050,16774,18753,11239,48,61,48061,36832,36950,40716,24532,35274,39239,47456,30933,72106,76189,88172,55465,421666,204948,216718,397718,2441,2900,14178,378081,38758,53875,92079.0,113789.0
2655,"Deaf Smith County, Texas",9387,856,798,528,799,798,816,428,48,117,48117,1638,1721,1939,1064,1533,1663,2040,1272,3171,3384,3979,2336,18736,9387,9349,16799,191,118,803,13646,49701,2666,4216.0,4608.0
2656,"El Paso County, Texas",411665,32635,31550,19816,31247,29517,32938,19079,48,141,48141,86371,81020,85139,42414,76174,81015,97289,57138,162545,162035,182428,99552,836062,411665,424397,666059,27876,10421,103148,690273,46871,121446,214008.0,254576.0
2657,"La Salle County, Texas",4322,204,209,103,119,184,235,211,48,283,48283,1124,898,897,654,452,526,758,609,1576,1424,1655,1263,7416,4322,3094,6454,108,12,566,6236,50151,1333,2059.0,2406.0
2658,"Terrell County, Texas",423,8,32,12,18,30,5,10,48,443,48443,13,95,91,152,40,53,176,141,53,148,267,293,896,423,473,592,10,0,269,508,43208,89,438.0,458.0
2659,"Tyler County, Texas",11699,561,585,443,455,590,491,377,48,457,48457,2702,1982,2693,2073,1239,1355,2742,2570,3941,3337,5435,4643,21518,11699,9819,18209,2305,70,407,1656,44497,3909,8016.0,9547.0
2660,"Wheeler County, Texas",2746,242,285,105,118,191,172,94,48,483,48483,308,517,624,503,333,493,670,521,641,1010,1294,1024,5338,2746,2592,4678,171,3,262,1388,49315,799,2306.0,2336.0
2661,"Archer County, Texas",4347,201,239,219,255,256,244,173,48,9,48009,592,802,1214,773,507,681,1324,929,1099,1483,2538,1702,8716,4347,4369,8315,83,15,43,722,63835,1993,4283.0,4796.0
2662,"Brewster County, Texas",4648,271,183,92,198,283,243,161,48,43,48043,633,846,1238,1047,641,858,1174,1025,1274,1704,2412,2072,9231,4648,4583,8352,19,170,217,4133,47080,1999,4252.0,4805.0
2663,"Hidalgo County, Texas",418867,40123,37684,23567,38480,37411,39506,22969,48,215,48215,77906,79863,76655,41071,76370,83505,86411,51657,154276,163368,163066,92728,855176,418867,436309,737739,4669,8370,88383,788282,40014,104272,173437.0,219939.0
2664,"Smith County, Texas",109770,8022,8170,4689,7507,7404,7766,4644,48,423,48423,18927,20149,25697,16306,19731,21567,28522,20538,38658,41716,54219,36844,227449,109770,117679,174650,39690,3868,4031,44360,56810,34653,84768.0,99521.0
2665,"Crockett County, Texas",1680,63,97,114,107,186,148,47,48,105,48105,270,338,499,215,182,384,444,306,452,722,943,521,3484,1680,1804,1494,24,0,1931,2156,47386,386,1395.0,1573.0
2666,"Haskell County, Texas",2964,65,155,95,167,170,136,111,48,207,48207,594,597,735,570,389,395,702,692,983,992,1437,1262,5726,2964,2762,5114,228,16,221,1636,40313,904,1770.0,2211.0
2667,"Howard County, Texas",20151,1148,1092,644,1162,1049,1119,596,48,227,48227,3702,4811,5340,2188,2718,3223,3839,2492,6420,8034,9179,4680,36349,20151,16198,30306,2020,252,2160,15452,54208,5731,8723.0,10043.0
2668,"Mills County, Texas",2376,105,219,36,62,60,208,102,48,333,48333,300,262,610,699,260,335,681,805,560,597,1291,1504,4889,2376,2513,4804,19,11,45,1026,49306,931,2245.0,2502.0
2669,"Montague County, Texas",9460,502,685,341,639,658,693,347,48,337,48337,1164,1449,2702,2015,1221,1505,2621,2345,2385,2954,5323,4360,19489,9460,10029,18607,131,0,231,2138,51765,3764,8604.0,9812.0
2670,"Panola County, Texas",11494,680,659,521,716,613,930,428,48,365,48365,1705,2171,2809,1992,1599,2236,2947,2364,3304,4407,5756,4356,23327,11494,11833,18899,4032,57,158,2034,52982,3941,10416.0,11452.0
2671,"Sabine County, Texas",5013,263,183,107,228,274,318,269,48,403,48403,511,700,1351,1577,531,656,1567,1615,1042,1356,2918,3192,10471,5013,5458,9348,591,10,80,477,34992,1880,4651.0,5462.0
2672,"Sherman County, Texas",1596,68,63,111,106,73,108,45,48,421,48421,255,295,506,182,142,357,406,226,397,652,912,408,3059,1596,1463,2702,37,0,176,1364,51926,451,935.0,990.0
2673,"Swisher County, Texas",4052,316,268,194,137,230,286,183,48,437,48437,767,798,775,673,455,648,749,692,1222,1446,1524,1365,7432,4052,3380,6222,448,12,133,3272,39771,1088,2204.0,2353.0
2674,"Hunt County, Texas",46261,2976,3098,1991,2930,3089,3142,1976,48,231,48231,7754,8191,12183,6744,7656,8408,12558,8142,15410,16599,24741,14886,94162,46261,47901,75231,7364,1216,7324,15396,54959,15828,31554.0,38517.0
2675,"Camp County, Texas",6266,580,548,249,305,490,490,292,48,63,48063,813,1053,1452,1128,985,1051,1749,1250,1798,2104,3201,2378,12878,6266,6612,9341,2136,56,919,3215,48207,2190,4542.0,5057.0
2676,"Hansford County, Texas",2817,267,172,126,180,201,195,212,48,195,48195,444,392,714,411,426,424,625,440,870,816,1339,851,5520,2817,2703,5055,17,4,382,2650,38000,610,1947.0,2046.0
2677,"Guadalupe County, Texas",78619,5097,6004,3705,4896,5858,5281,3622,48,187,48187,12128,16497,19485,9833,11586,16762,20505,11837,23714,33259,39990,21670,158966,78619,80347,116778,13085,2720,20444,60278,74496,29491,57822.0,77382.0
2678,"Clay County, Texas",5214,231,280,203,227,297,311,198,48,77,48077,668,836,1480,1136,579,818,1522,1237,1247,1654,3002,2373,10403,5214,5189,9879,52,117,83,653,55989,2362,5018.0,5736.0
2679,"Hartley County, Texas",3346,191,134,59,119,130,204,157,48,205,48205,448,1122,788,380,300,435,506,472,748,1557,1294,852,5669,3346,2323,4808,425,82,106,1515,58298,1242,1952.0,2076.0
2680,"Reagan County, Texas",1955,202,245,53,126,182,191,70,48,383,48383,314,464,346,169,335,363,405,139,649,827,751,308,3766,1955,1811,1719,32,6,1944,2592,74868,314,904.0,1124.0
2681,"Hill County, Texas",17809,1214,1047,754,890,1305,1029,732,48,217,48217,2503,2831,4622,3488,2389,2925,4766,3844,4892,5756,9388,7332,35689,17809,17880,30697,2340,143,1367,7354,53307,6267,12970.0,14843.0
2682,"Limestone County, Texas",12010,718,692,503,750,718,672,440,48,293,48293,2046,2295,2961,2014,1513,1905,3034,2375,3559,4200,5995,4389,23417,12010,11407,18013,4037,177,458,5130,44418,3385,7739.0,9092.0
2683,"Nacogdoches County, Texas",31350,2184,2217,1221,2085,2109,2024,1204,48,347,48347,7800,4886,6765,4146,8898,5218,7311,5140,16698,10104,14076,9286,65339,31350,33989,49935,11583,1055,804,12690,44847,9868,22622.0,26755.0
2684,"Parmer County, Texas",4982,407,390,205,347,368,468,255,48,369,48369,882,1007,1058,623,659,825,1125,689,1541,1832,2183,1312,9718,4982,4736,8409,116,42,570,6151,55359,1471,2466.0,2648.0
2685,"Parker County, Texas",66500,4194,5079,2998,4062,4065,5131,2937,48,367,48367,9316,12236,18281,9719,8977,12470,18877,10792,18293,24706,37158,20511,133811,66500,67311,124714,1781,757,2027,16443,77503,24456,56817.0,75434.0
2686,"Ravalli County, Montana",21114,942,1198,908,976,952,1198,763,30,81,30081,2350,3123,6152,5153,2104,3394,6490,5521,4454,6517,12642,10674,42512,21114,21398,40736,55,226,94,1490,53054,9519,22556.0,28490.0
2687,"Valley County, Montana",3700,229,217,171,203,136,313,134,30,105,30105,434,618,1019,769,516,595,985,889,950,1213,2004,1658,7471,3700,3771,6429,29,16,46,203,53162,1463,3894.0,4272.0
2688,"Cascade County, Montana",41235,2966,2473,1390,2529,2593,2355,1320,30,13,30013,7453,7551,9763,6920,6382,6922,10259,8030,13835,14473,20022,14950,81625,41235,40390,71577,1080,595,1023,3682,49913,16474,34571.0,39688.0
2689,"Fergus County, Montana",5742,414,239,208,291,298,285,170,30,27,30027,689,921,1540,1290,706,915,1499,1315,1395,1836,3039,2605,11221,5742,5479,10602,15,66,52,104,50540,2341,5840.0,6487.0
2690,"Garfield County, Montana",552,55,42,31,14,18,17,16,30,33,30033,63,72,128,142,63,101,158,97,126,173,286,239,1036,552,484,1029,7,0,0,1,42000,221,718.0,813.0
2691,"Mineral County, Montana",2177,101,103,68,85,115,107,103,30,61,30061,217,314,643,629,204,274,622,564,421,588,1265,1193,4251,2177,2074,3942,34,36,6,56,41705,809,2012.0,2562.0
2692,"Petroleum County, Montana",235,18,8,6,16,2,8,4,30,69,30069,10,36,77,51,13,41,84,50,23,77,161,101,453,235,218,428,0,25,0,0,51250,184,322.0,351.0
2693,"Powell County, Montana",4294,125,150,66,126,106,190,132,30,77,30077,794,971,1332,721,231,350,775,650,1025,1321,2107,1371,6854,4294,2560,6187,64,26,13,119,54667,1788,2794.0,3187.0
2694,"Sanders County, Montana",5995,295,367,207,248,208,347,170,30,89,30089,555,773,1740,1819,505,777,1744,1687,1060,1550,3484,3506,11681,5995,5686,10803,36,49,27,352,40823,2624,5953.0,7651.0
2695,"Wibaux County, Montana",524,35,33,29,80,30,35,13,30,109,30109,24,74,172,111,51,65,185,139,75,139,357,250,1122,524,598,1101,0,8,0,55,53958,267,541.0,598.0
2696,"Gallatin County, Montana",56112,3190,2937,1716,2954,3065,2946,1589,30,31,30031,14603,11989,12076,6350,12065,10838,11629,6865,26668,22827,23705,13215,108063,56112,51951,101395,426,1472,1084,4032,66397,23866,53819.0,71363.0
2697,"Meagher County, Montana",974,80,22,19,72,57,65,0,30,59,30059,182,134,267,222,125,117,247,231,307,251,514,453,1888,974,914,1749,1,3,88,88,46607,498,977.0,1110.0
2698,"Carbon County, Montana",5372,180,307,219,197,218,314,161,30,9,30009,527,828,1711,1318,460,911,1634,1330,987,1739,3345,2648,10597,5372,5225,10240,43,30,27,261,58707,2576,5991.0,7045.0
2699,"Beaverhead County, Montana",4682,222,209,187,230,261,200,135,30,1,30001,909,699,1217,1029,923,714,1289,981,1832,1413,2506,2010,9415,4682,4733,8922,7,59,40,465,43201,2042,4849.0,5661.0
2700,"Flathead County, Montana",49898,2934,3253,1897,2764,2713,3217,1851,30,29,30029,6447,9308,13585,9081,6343,9184,14327,9602,12790,18492,27912,18683,99899,49898,50001,93989,440,698,947,2829,56182,21846,46571.0,60132.0
2701,"Musselshell County, Montana",2379,92,91,112,99,184,80,101,30,65,30065,225,349,706,617,251,302,752,618,476,651,1458,1235,4766,2379,2387,4484,0,43,6,147,43274,1057,2441.0,2881.0
2702,"Harlan County, Nebraska",1733,104,138,61,102,93,155,87,31,83,31083,193,258,461,431,166,251,414,414,359,509,875,845,3415,1733,1682,3289,18,7,32,89,49835,631,1832.0,1928.0
2703,"York County, Nebraska",6708,451,494,309,406,412,408,231,31,185,31185,1058,1092,1644,1209,1067,1212,1800,1501,2125,2304,3444,2710,13745,6708,7037,13012,214,58,179,709,60298,2894,6381.0,7089.0
2704,"Buffalo County, Nebraska",24601,1769,1680,1009,1582,1602,1453,835,31,19,31019,5292,4903,5277,3052,5411,4453,5461,3811,10703,9356,10738,6863,49209,24601,24608,45150,492,643,1843,4429,59431,9651,21129.0,23474.0
2705,"Colfax County, Nebraska",5936,666,473,311,286,334,554,175,31,37,31037,860,1174,1434,626,667,997,1043,722,1527,2171,2477,1348,10714,5936,4778,9512,401,79,347,4869,58872,1617,3214.0,3724.0
2706,"Hitchcock County, Nebraska",1400,81,105,58,81,72,99,54,31,87,31087,139,229,372,322,128,228,363,390,267,457,735,712,2815,1400,1415,2802,2,0,1,15,49962,580,1468.0,1464.0
2707,"Platte County, Nebraska",16998,1235,1198,763,1165,1077,1229,643,31,141,31141,2510,3150,4103,2650,2163,2851,3964,3084,4673,6001,8067,5734,33174,16998,16176,31464,179,249,750,6297,62305,5740,14433.0,15256.0
2708,"Polk County, Nebraska",2546,133,138,111,133,175,216,110,31,143,31143,301,392,758,530,297,414,725,609,598,806,1483,1139,5225,2546,2679,5084,9,0,49,288,67719,1010,2582.0,2870.0
2709,"Box Butte County, Nebraska",5505,298,515,271,417,365,334,195,31,13,31013,640,980,1545,857,728,1037,1362,1027,1368,2017,2907,1884,10970,5505,5465,10144,149,119,64,1376,54004,2042,4924.0,5181.0
2710,"Brown County, Nebraska",1462,80,141,23,74,66,121,51,31,17,31017,148,237,420,369,161,222,413,445,309,459,833,814,3015,1462,1553,2935,1,14,0,54,43098,664,1597.0,1676.0
2711,"Sheridan County, Nebraska",2535,134,140,108,129,178,179,137,31,161,31161,304,400,681,610,257,377,726,713,561,777,1407,1323,5231,2535,2696,4322,109,48,34,289,45371,1071,2608.0,2672.0
2712,"Lancaster County, Nebraska",157231,10438,10370,5797,9647,9340,10456,5505,31,109,31109,36047,31180,34582,18696,33883,28697,34918,23481,69930,59877,69500,42177,313158,157231,155927,269630,12501,13153,4248,22068,60527,61924,136223.0,153031.0
2713,"Nuckolls County, Nebraska",2114,109,116,79,114,118,128,70,31,129,31129,237,328,587,505,209,295,570,626,446,623,1157,1131,4244,2114,2130,4127,6,75,1,119,43388,830,2205.0,2296.0
2714,"Banner County, Nebraska",350,37,29,5,26,14,17,24,31,7,31007,42,55,97,74,20,64,126,81,62,119,223,155,722,350,372,693,0,10,3,44,51750,135,402.0,410.0
2715,"Frontier County, Nebraska",1349,65,86,61,64,67,60,47,31,63,31063,227,168,348,326,220,177,314,342,447,345,662,668,2640,1349,1291,2569,15,2,0,33,54659,519,1328.0,1440.0
2716,"Douglas County, Nebraska",276459,21658,20266,11576,20601,19954,18893,11206,31,55,31055,47392,59592,64982,30873,47460,58666,67357,40021,94852,118258,132339,70894,560617,276459,284158,443883,62004,21389,11836,70367,64629,114846,240433.0,269960.0
2717,"Richardson County, Nebraska",3973,226,249,177,208,256,185,128,31,147,31147,428,617,1150,854,391,626,1129,1065,819,1243,2279,1919,7961,3973,3988,7462,16,6,3,155,47917,1733,3805.0,4018.0
2718,"Holt County, Nebraska",5128,342,341,197,294,281,425,172,31,89,31089,573,862,1388,997,568,748,1365,1196,1141,1610,2753,2193,10177,5128,5049,9933,14,57,20,496,60387,2169,5118.0,5531.0
2719,"Furnas County, Nebraska",2347,145,135,101,135,157,128,108,31,65,31065,294,334,674,515,260,351,614,647,554,685,1288,1162,4747,2347,2400,4589,6,14,32,204,48838,858,2340.0,2601.0
2720,"Saline County, Nebraska",7263,420,476,258,501,552,437,298,31,151,31151,1513,1288,1754,954,1288,1255,1572,1104,2801,2543,3326,2058,14270,7263,7007,12674,354,281,523,3616,51502,2491,5136.0,5336.0
2721,"Thurston County, Nebraska",3566,352,364,207,347,332,361,193,31,173,31173,627,525,683,384,603,532,774,473,1230,1057,1457,857,7181,3566,3615,2753,14,59,12,427,51034,826,2088.0,2294.0
2722,"Washington County, Nebraska",10058,649,698,491,557,684,704,451,31,177,31177,1213,1738,2822,1678,1219,1819,2916,1953,2432,3557,5738,3631,20361,10058,10303,19667,221,53,75,593,71430,4650,10832.0,12413.0
2723,"Cherry County, Nebraska",2940,213,171,144,185,155,173,135,31,31,31031,401,513,777,555,302,510,739,640,703,1023,1516,1195,5779,2940,2839,5168,1,28,7,145,56651,1312,3118.0,3265.0
2724,"Dodge County, Nebraska",18022,1343,1340,698,1136,1155,1277,732,31,53,31053,2696,3232,4565,3042,2737,3131,4540,3935,5433,6363,9105,6977,36665,18022,18643,34718,350,129,397,4718,54085,6341,15529.0,16880.0
2725,"Garden County, Nebraska",942,43,23,35,36,24,81,45,31,69,31069,72,153,276,252,49,169,254,264,121,322,530,516,1864,942,922,1836,3,3,7,86,43750,371,1075.0,1195.0
2726,"Morrill County, Nebraska",2426,130,230,114,160,133,178,76,31,123,31123,313,430,621,476,264,400,658,486,577,830,1279,962,4781,2426,2355,4556,37,23,52,737,46194,947,2209.0,2558.0
2727,"Nemaha County, Nebraska",3486,213,170,125,174,252,154,135,31,127,31127,673,590,829,643,645,530,863,734,1318,1120,1692,1377,6973,3486,3487,6684,105,53,41,194,51828,1325,3161.0,3423.0
2728,"Thomas County, Nebraska",289,14,22,15,21,28,12,4,31,171,31171,36,69,68,54,54,61,93,83,90,130,161,137,645,289,356,613,0,0,0,0,59432,115,393.0,427.0
2729,"Dakota County, Nebraska",10125,861,706,628,877,708,906,300,31,43,31043,1609,1908,2267,1265,1623,1876,2317,1441,3232,3784,4584,2706,20173,10125,10048,13877,1099,678,3480,7823,59231,2877,6279.0,6794.0
2730,"Antelope County, Nebraska",3186,218,199,129,192,214,184,120,31,3,31003,392,479,861,673,348,467,848,782,740,946,1709,1455,6341,3186,3155,6168,63,15,65,210,49912,1222,3281.0,3583.0
2731,"Chase County, Nebraska",1833,115,81,61,69,146,152,91,31,29,31029,225,319,506,367,194,335,501,462,419,654,1007,829,3783,1833,1950,3758,2,10,0,465,57009,692,1898.0,1993.0
2732,"Clay County, Nebraska",3159,221,241,132,196,205,217,125,31,35,31035,407,488,871,601,366,485,815,635,773,973,1686,1236,6203,3159,3044,5995,13,5,63,549,57173,1179,3065.0,3558.0
2733,"Custer County, Nebraska",5377,342,324,217,341,394,349,203,31,41,31041,702,926,1408,1077,643,839,1389,1291,1345,1765,2797,2368,10826,5377,5449,10474,17,82,84,347,52184,2244,5652.0,5877.0
2734,"Franklin County, Nebraska",1473,74,98,45,74,62,79,54,31,61,31061,154,212,447,372,164,216,428,437,318,428,875,809,2987,1473,1514,2918,15,6,9,69,49282,613,1673.0,1721.0
2735,"Hamilton County, Nebraska",4575,295,278,220,269,230,330,216,31,81,31081,591,761,1227,857,593,752,1309,941,1184,1513,2536,1798,9215,4575,4640,8856,17,33,142,325,64210,1867,5004.0,5520.0
2736,"Jefferson County, Nebraska",3473,173,334,125,226,162,280,157,31,95,31095,381,574,1032,747,382,525,1000,939,763,1099,2032,1686,7144,3473,3671,6926,45,15,28,305,44510,1478,3494.0,3686.0
2737,"Keith County, Nebraska",4130,199,299,132,170,234,231,120,31,101,31101,427,674,1108,1052,406,597,1077,1103,833,1271,2185,2155,8068,4130,3938,7745,98,62,32,584,50735,1456,4034.0,4364.0
2738,"Loup County, Nebraska",313,12,17,16,27,5,6,4,31,115,31115,64,33,101,64,30,37,99,84,94,70,200,148,605,313,292,603,0,0,0,11,51000,136,385.0,454.0
2739,"Perkins County, Nebraska",1500,92,118,79,102,83,96,44,31,135,31135,165,274,349,317,133,237,356,350,298,511,705,667,2901,1500,1401,2861,4,0,17,122,65543,563,1455.0,1545.0
2740,"Saunders County, Nebraska",10692,639,711,488,661,857,566,403,31,155,31155,1378,1787,2995,1872,1239,1802,2946,1999,2617,3589,5941,3871,21165,10692,10473,20601,104,89,31,482,68682,4437,10860.0,12646.0
2741,"Scotts Bluff County, Nebraska",17450,1234,1299,751,1169,1286,1283,703,31,157,31157,2616,3119,4307,2876,2511,3141,4658,3873,5127,6260,8965,6749,36074,17450,18624,33042,321,237,878,8594,49745,6587,14317.0,15289.0
2742,"Keya Paha County, Nebraska",366,22,19,21,18,10,34,52,31,103,31103,50,43,100,88,23,61,101,95,73,104,201,183,760,366,394,749,0,0,1,7,56500,146,479.0,529.0
2743,"Kimball County, Nebraska",1816,85,107,65,56,104,157,72,31,105,31105,213,295,522,394,196,257,476,499,409,552,998,893,3633,1816,1817,3423,3,12,5,347,53403,672,1677.0,1860.0
2744,"Lincoln County, Nebraska",17300,1033,1183,681,1022,1169,1225,808,31,111,31111,2352,3338,4509,2971,2170,3318,4561,3690,4522,6656,9070,6661,35263,17300,17963,33426,542,312,266,3046,59795,6438,16131.0,17151.0
2745,"Presidio County, Texas",3352,99,327,120,393,251,164,141,48,377,48377,504,501,698,789,409,579,792,894,913,1080,1490,1683,6975,3352,3623,6561,0,94,116,5841,25098,866,2208.0,2217.0
2746,"Val Verde County, Texas",24997,2101,1646,1172,2031,1692,1989,1151,48,465,48465,5255,4791,4695,3175,4108,4204,5044,3753,9363,8995,9739,6928,48969,24997,23972,45407,706,369,1853,40131,46147,6037,13617.0,14417.0
2747,"Culberson County, Texas",1260,122,139,83,108,48,61,19,48,109,48109,205,198,270,185,128,148,300,142,333,346,570,327,2214,1260,954,1733,3,13,402,1573,37900,303,767.0,864.0
2748,"Ector County, Texas",81516,7469,7128,3658,7159,7020,5998,3521,48,135,48135,16169,17545,16350,6695,14567,15737,16519,8542,30736,33282,32869,15237,160579,81516,79063,129198,7702,1909,15994,97439,62973,22409,36530.0,44417.0
2749,"Garza County, Texas",3829,72,104,129,188,157,61,114,48,169,48169,770,1169,1074,374,357,304,600,460,1127,1473,1674,834,6070,3829,2241,5120,347,119,387,3170,49627,1017,1484.0,1651.0
2750,"Glasscock County, Texas",867,64,46,18,0,0,61,46,48,173,48173,160,253,153,65,149,129,174,84,309,382,327,149,1510,867,643,1003,0,0,507,661,78456,159,604.0,653.0
2751,"Grimes County, Texas",15171,605,1032,607,925,749,967,526,48,185,48185,2432,3015,4226,2356,1616,2241,3404,2385,4048,5256,7630,4741,27984,15171,12813,21756,4244,55,1003,6761,52913,4589,9533.0,12398.0
2752,"Collin County, Texas",479151,30944,35778,23689,29956,35032,37999,22718,48,85,48085,69673,107316,126046,45703,67445,114979,128365,58332,137118,222295,254411,104035,973977,479151,494826,673508,94720,147553,22767,148696,96913,252386,361419.0,486917.0
2753,"Angelina County, Texas",42606,2997,2947,1911,2912,3445,2893,1921,48,5,48005,6701,7849,10666,6113,6793,8117,10901,7734,13494,15966,21567,13847,87322,42606,44716,69651,12890,975,1893,19326,50453,13743,29911.0,34628.0
2754,"Cottle County, Texas",741,85,35,53,70,89,31,55,48,101,48101,77,49,209,138,142,114,197,203,219,163,406,341,1642,741,901,1149,238,0,159,380,32305,252,612.0,665.0
2755,"Hays County, Texas",106252,6755,6965,4155,6261,6778,7075,3930,48,209,48209,25702,21782,22973,10470,25696,21245,23781,12348,51398,43027,46754,22818,213366,106252,107114,188901,8997,3348,6004,83069,68717,40274,72164.0,108822.0
2756,"Brazoria County, Texas",182333,12868,14629,8268,12155,12889,13757,7866,48,39,48039,27918,40457,45818,19188,25737,38995,44388,22557,53655,79452,90206,41745,360677,182333,178344,261164,50437,24110,14522,110463,81447,74346,121181.0,154037.0
2757,"Donley County, Texas",1700,110,95,70,57,71,123,47,48,129,48129,347,232,404,347,297,227,391,429,644,459,795,776,3342,1700,1642,3002,189,12,59,370,42961,526,1465.0,1648.0
2758,"Atascosa County, Texas",24733,1825,1928,1153,1812,1546,2162,1165,48,13,48013,3833,4793,5871,3303,3885,4599,5830,3796,7718,9392,11701,7099,49528,24733,24795,45761,135,173,992,31855,55366,8024,13673.0,18085.0
2759,"Nolan County, Texas",7643,547,552,431,531,503,579,191,48,353,48353,1309,1313,1764,1189,970,1224,1822,1441,2279,2537,3586,2630,14904,7643,7261,13090,888,43,643,5616,45537,2310,4857.0,5352.0
2760,"Hudspeth County, Texas",2218,153,149,54,58,297,120,149,48,229,48229,418,522,467,352,309,408,533,323,727,930,1000,675,4415,2218,2197,2974,89,34,1197,3435,31677,421,871.0,1157.0
2761,"Ward County, Texas",5812,383,479,248,468,384,513,319,48,475,48475,1069,1198,1283,724,917,1086,1277,882,1986,2284,2560,1606,11658,5812,5846,10052,469,111,674,6256,62986,1868,3445.0,4034.0
2762,"Harrison County, Texas",32338,1929,2323,1542,2344,2259,2481,1437,48,203,48203,4824,5781,8400,4954,4820,6314,8576,6011,9644,12095,16976,10965,66580,32338,34242,49704,13760,528,1020,8727,52220,11007,26548.0,29462.0
2763,"Menard County, Texas",1158,0,60,19,9,43,46,13,48,327,48327,189,150,295,369,115,115,323,297,304,265,618,666,2119,1158,961,1710,1,0,218,883,36395,422,864.0,1023.0
2764,"Fayette County, Texas",12393,674,818,363,594,675,753,490,48,149,48149,1444,1951,3478,2875,1428,1954,3542,3312,2872,3905,7020,6187,25141,12393,12748,22671,1645,125,497,5276,60189,5175,11174.0,12924.0
2765,"Williamson County, Texas",269549,18540,20323,12329,17552,19201,20619,12033,48,491,48491,38965,64766,64249,28651,38915,66520,67126,36089,77880,131286,131375,64740,547604,269549,278055,436477,35054,37395,13845,133872,87337,118445,203081.0,287696.0
2766,"Hutchinson County, Texas",10772,725,719,520,670,883,637,514,48,233,48233,1570,2013,2774,1633,1469,1904,2658,1837,3039,3917,5432,3470,21344,10772,10572,19043,344,82,474,4964,52524,3740,8155.0,8741.0
2767,"Morris County, Texas",5865,334,385,173,349,379,433,285,48,343,48343,777,1013,1468,1211,822,1081,1713,1446,1599,2094,3181,2657,12373,5865,6508,8570,2882,20,517,1220,41359,2061,4973.0,5548.0
2768,"Orange County, Texas",41719,2994,2994,1803,2763,2768,2782,1740,48,361,48361,6399,7698,10950,5875,6098,7837,11127,7235,12497,15535,22077,13110,84069,41719,42350,73496,7327,1022,561,6456,59399,14982,32000.0,35974.0
2769,"Winkler County, Texas",4049,368,283,201,254,410,270,194,48,495,48495,715,776,929,405,604,764,821,501,1319,1540,1750,906,7867,4049,3818,6909,393,0,172,4796,60366,881,1876.0,2126.0
2770,"Harris County, Texas",2309012,179314,174236,102253,173156,170054,170397,98100,48,201,48201,413996,523686,528427,208718,402422,512582,547477,263430,816418,1036268,1075904,472148,4646630,2309012,2337618,2905947,884292,324288,396777,1995115,61705,826687,1312112.0,1633671.0
2771,"Burnet County, Texas",22992,1244,1268,1033,1173,1151,1574,914,48,53,48053,3238,3601,6190,4824,2943,3756,6648,5379,6181,7357,12838,10203,46530,22992,23538,42519,815,400,1807,10342,59492,8857,19204.0,24646.0
2772,"Gillespie County, Texas",12798,654,649,513,662,603,828,493,48,171,48171,1456,1855,3126,3617,1382,1857,3695,4141,2838,3712,6821,7758,26459,12798,13661,24065,29,32,671,6132,59155,5886,13214.0,15817.0
2773,"Dallas County, Texas",1285388,99742,96872,55695,95205,95113,92436,54238,48,113,48113,237044,282172,298699,117127,234704,284074,310107,155603,471748,566246,608806,272730,2606868,1285388,1321480,1597069,588903,163971,176677,1047434,59607,460345,758973.0,919929.0
2774,"McMullen County, Texas",413,34,29,9,30,26,61,7,48,311,48311,60,95,86,72,30,81,56,70,90,176,142,142,774,413,361,765,0,0,0,385,62000,125,499.0,516.0
2775,"Young County, Texas",8785,499,627,342,561,609,702,400,48,503,48503,1205,1496,2332,1648,997,1637,2312,2033,2202,3133,4644,3681,18036,8785,9251,17264,379,48,140,3366,50635,3076,7707.0,8242.0
2776,"Johnson County, Texas",83534,5596,6305,3929,5419,5572,6433,3719,48,251,48251,12792,16314,21555,10450,12065,16229,21545,12696,24857,32543,43100,23146,167212,83534,83678,151615,5962,1627,3357,35714,64359,29505,57606.0,71928.0
2777,"Hopkins County, Texas",17904,1194,1421,770,1117,986,1528,826,48,223,48223,2605,3089,4535,3042,2462,3439,4600,3624,5067,6528,9135,6666,36486,17904,18582,30839,2586,243,1930,6157,52078,6610,13538.0,15932.0
2778,"Ochiltree County, Texas",5127,462,323,281,388,452,433,243,48,357,48357,838,965,1185,502,796,980,1150,562,1634,1945,2335,1064,10131,5127,5004,8884,82,26,739,5489,50464,1268,3002.0,3155.0
2779,"Knox County, Texas",1845,158,106,93,105,187,133,53,48,275,48275,228,329,508,270,222,277,474,409,450,606,982,679,3705,1845,1860,3142,206,40,213,1272,48798,668,1367.0,1456.0
2780,"McLennan County, Texas",122580,8966,8074,5558,8598,8585,8010,5017,48,309,48309,26746,21713,26791,15420,26743,22589,28885,20082,53489,44302,55676,35502,251089,122580,128509,196885,36746,4053,6552,66148,49778,37983,79075.0,97617.0
2781,"Concho County, Texas",2098,75,56,64,19,90,41,22,48,95,48095,273,551,619,331,102,187,386,321,375,738,1005,652,3266,2098,1168,3157,41,13,32,1474,47500,654,1068.0,1268.0
2782,"Edwards County, Texas",993,42,106,26,40,15,55,0,48,137,48137,117,133,208,361,132,170,288,225,249,303,496,586,1918,993,925,1912,0,0,4,1086,40766,310,1073.0,1064.0
2783,"Eastland County, Texas",9150,551,663,316,537,407,629,362,48,133,48133,1702,1484,2199,1877,1267,1392,2315,2214,2969,2876,4514,4091,18273,9150,9123,16816,599,123,542,2989,37276,2833,6963.0,8271.0
2784,"Jeff Davis County, Texas",988,12,28,28,49,38,147,26,48,243,48243,114,86,262,410,100,164,376,353,214,250,638,763,2241,988,1253,2167,23,0,34,893,53088,407,1191.0,1304.0
2785,"Jim Hogg County, Texas",2557,276,164,183,244,203,171,113,48,247,48247,379,372,620,244,377,508,558,500,756,880,1178,744,5231,2557,2674,5165,17,0,12,4778,33382,764,2119.0,2034.0
2786,"Montgomery County, Texas",283117,19781,21999,13265,18920,21255,21109,12961,48,339,48339,42000,57334,73451,33248,40749,58439,75295,40104,82749,115773,148746,73352,571949,283117,288832,494422,28396,16868,14577,138081,80902,109540,204632.0,271175.0
2787,"Dimmit County, Texas",5060,387,492,245,364,394,563,204,48,127,48127,831,945,945,795,807,1018,1060,968,1638,1963,2005,1763,10438,5060,5378,9366,4,147,859,9072,27161,1479,3225.0,3666.0
2788,"Webb County, Texas",133948,13446,11672,7576,12634,12254,12404,7400,48,479,48479,25577,26086,25312,10752,25102,26775,28620,14389,50679,52861,53932,25141,273526,133948,139578,262244,1215,1387,6653,261132,46475,34027,56905.0,68439.0
2789,"Armstrong County, Texas",982,52,49,59,66,46,73,25,48,11,48011,98,172,279,187,92,163,288,238,190,335,567,425,1973,982,991,1833,5,0,42,149,72500,347,1021.0,1112.0
2790,"Castro County, Texas",3853,276,444,147,319,333,324,177,48,69,48069,595,705,927,549,595,665,792,615,1190,1370,1719,1164,7673,3853,3820,6972,163,47,208,4957,50142,1204,1997.0,2082.0
2791,"Kleberg County, Texas",15656,1077,1193,621,1048,1106,934,669,48,273,48273,4568,2725,2734,1863,4137,2433,2824,2167,8705,5158,5558,4030,30974,15656,15318,27421,1018,695,1076,22574,43730,4708,9512.0,11041.0
2792,"Cooke County, Texas",19871,1438,1298,973,1293,1242,1267,751,48,97,48097,3101,3274,5158,3341,2868,3366,5455,3928,5969,6640,10613,7269,40041,19871,20170,36719,1125,344,370,7269,60202,6607,15955.0,18997.0
2793,"Crosby County, Texas",2899,199,210,133,191,167,255,132,48,107,48107,428,546,621,481,417,516,680,579,845,1062,1301,1060,5836,2899,2937,5148,212,33,342,3269,40759,922,1728.0,1953.0
2794,"Fisher County, Texas",1833,134,105,58,167,100,132,74,48,151,48151,251,291,521,373,265,292,486,507,516,583,1007,880,3856,1833,2023,3408,102,12,103,1261,46146,726,1729.0,1826.0
2795,"Duval County, Texas",5717,378,365,201,427,264,597,211,48,131,48131,1047,1081,1278,910,919,823,1242,1068,1966,1904,2520,1978,11268,5717,5551,10705,148,0,406,10066,41186,1344,4168.0,5050.0
2796,"Blanco County, Texas",5931,309,445,194,177,174,318,226,48,31,48031,625,832,1899,1372,491,858,1801,1502,1116,1690,3700,2874,11478,5931,5547,10256,3,165,403,2224,66390,2352,5685.0,7419.0
2797,"Jasper County, Texas",17510,1030,1284,654,1064,1142,1230,794,48,241,48241,2488,3011,4474,3197,2195,3044,4849,3678,4683,6055,9323,6875,35506,17510,17996,27455,5889,177,1343,2386,44370,6122,13419.0,15469.0
2798,"Jefferson County, Texas",130051,9056,8770,4932,8519,8795,7801,4759,48,245,48245,23312,27740,32064,15887,20251,22899,31014,20251,43563,50639,63078,36138,254340,130051,124289,148331,85682,9565,5363,52708,51248,38393,87618.0,94665.0
2799,"Kinney County, Texas",2170,91,79,66,9,23,81,64,48,271,48271,216,591,650,420,131,202,495,484,347,793,1145,904,3659,2170,1489,3521,5,0,131,2169,26738,853,1430.0,1603.0
2800,"Oldham County, Texas",1106,69,81,77,51,42,117,87,48,359,48359,96,222,224,157,156,133,250,152,252,355,474,309,2094,1106,988,1928,66,39,1,319,64545,383,948.0,1009.0
2801,"Lamb County, Texas",6583,496,564,306,468,458,562,294,48,279,48279,1041,1148,1555,955,856,1121,1567,1214,1897,2269,3122,2169,13123,6583,6540,11819,515,73,320,7291,45111,2036,3995.0,4394.0
2802,"Lipscomb County, Texas",1712,159,184,64,95,92,137,72,48,295,48295,281,327,347,251,270,285,405,330,551,612,752,581,3398,1712,1686,2779,18,66,336,1086,59091,639,1332.0,1351.0
2803,"McCulloch County, Texas",4366,458,288,292,54,166,332,32,48,307,48307,608,569,1110,847,491,579,1125,912,1099,1148,2235,1759,8057,4366,3691,6668,87,60,807,2603,47707,1256,3103.0,3430.0
2804,"Mason County, Texas",2257,206,181,63,66,107,58,123,48,319,48319,210,304,623,478,258,262,512,543,468,566,1135,1021,4186,2257,1929,3705,2,101,50,929,42276,720,2057.0,2700.0
2805,"Dickens County, Texas",1084,78,28,32,38,78,58,59,48,125,48125,176,222,273,204,55,179,332,320,231,401,605,524,2203,1084,1119,2023,59,11,84,657,42540,399,909.0,985.0
2806,"Pierce County, Nebraska",3555,218,249,154,246,268,214,165,31,139,31139,440,621,977,620,400,573,993,730,840,1194,1970,1350,7144,3555,3589,6937,15,44,3,109,64511,1509,3630.0,4006.0
2807,"Sioux County, Nebraska",587,40,46,7,81,27,15,5,31,165,31165,75,79,166,141,101,105,169,129,176,184,335,270,1219,587,632,1130,5,0,40,41,48269,255,736.0,729.0
2808,"Burt County, Nebraska",3177,186,254,133,145,225,208,108,31,21,31021,342,465,913,681,357,548,883,859,699,1013,1796,1540,6510,3177,3333,6180,31,51,22,200,54203,1405,3558.0,3709.0
2809,"Cass County, Nebraska",13070,781,1064,570,717,816,905,529,31,25,31025,1647,2362,3729,2067,1419,2321,3782,2329,3066,4683,7511,4396,25888,13070,12818,24821,87,77,191,867,71846,5384,12933.0,15318.0
2810,"Cuming County, Nebraska",4487,258,235,154,298,280,335,230,31,39,31039,569,688,1287,884,501,684,1077,1060,1070,1372,2364,1944,8952,4487,4465,8432,9,27,327,905,56768,1864,4074.0,4412.0
2811,"Dixon County, Nebraska",2909,175,167,146,223,221,110,103,31,51,31051,377,448,790,524,346,479,710,618,723,927,1500,1142,5719,2909,2810,5328,25,22,264,786,56905,1249,2782.0,3083.0
2812,"Dundy County, Nebraska",977,48,67,32,81,66,40,19,31,57,31057,94,173,256,202,142,150,228,210,236,323,484,412,1913,977,936,1902,4,0,0,226,41716,285,953.0,999.0
2813,"Grant County, Nebraska",387,16,24,16,41,17,13,11,31,75,31075,67,57,94,79,38,51,91,73,105,108,185,152,722,387,335,700,6,0,6,9,46500,162,405.0,402.0
2814,"Greeley County, Nebraska",1172,72,59,51,79,69,89,48,31,77,31077,128,186,302,281,130,169,305,321,258,355,607,602,2382,1172,1210,2322,10,4,21,50,47869,434,1175.0,1258.0
2815,"Hall County, Nebraska",30884,2498,2265,1378,2206,2270,2275,1271,31,79,31079,4749,5879,7438,4039,4264,5822,7374,4899,9013,11701,14812,8938,61265,30884,30381,51453,1691,672,5760,16986,57104,10601,22060.0,23999.0
2816,"Hayes County, Nebraska",464,32,28,14,27,39,24,7,31,85,31085,57,88,144,82,33,73,142,84,90,161,286,166,893,464,429,878,0,0,15,74,51726,126,514.0,532.0
2817,"Otoe County, Nebraska",7817,543,444,322,553,554,455,327,31,131,31131,1114,1375,2069,1321,954,1348,2208,1733,2068,2723,4277,3054,15949,7817,8132,15002,66,54,351,1288,59167,3100,7457.0,8306.0
2818,"Red Willow County, Nebraska",5346,300,294,222,303,302,358,274,31,145,31145,832,944,1368,982,704,886,1422,1173,1536,1830,2790,2155,10768,5346,5422,10305,66,8,79,566,48808,2045,5170.0,5452.0
2819,"Cedar County, Nebraska",4327,297,346,180,265,279,274,176,31,27,31027,495,663,1167,840,477,610,1124,966,972,1273,2291,1806,8498,4327,4171,8279,13,5,80,175,61869,1773,4420.0,4996.0
2820,"Dawes County, Nebraska",4266,251,167,131,197,228,204,149,31,45,31045,1097,633,1012,726,1337,589,956,884,2434,1222,1968,1610,8810,4266,4544,7932,385,59,0,472,50750,1880,3676.0,4102.0
2821,"Johnson County, Nebraska",3071,136,154,95,99,129,149,83,31,97,31097,542,750,857,421,220,309,583,518,762,1059,1440,939,5161,3071,2090,4458,313,81,220,527,54712,1169,2089.0,2227.0
2822,"Cheyenne County, Nebraska",4759,287,303,181,363,321,289,203,31,33,31033,610,914,1365,790,632,843,1205,989,1242,1757,2570,1779,9604,4759,4845,9112,80,66,42,671,53871,1864,4711.0,4765.0
2823,"Dawson County, Nebraska",12279,1008,797,622,1023,893,732,522,31,47,31047,1825,2372,3049,1705,1657,1995,2641,1991,3482,4367,5690,3696,23733,12279,11454,20758,1504,149,905,7893,53721,3309,8635.0,9191.0
2824,"Garfield County, Nebraska",1005,48,45,52,41,63,43,30,31,71,31071,139,118,267,261,111,132,266,310,250,250,533,571,2001,1005,996,1958,7,4,32,37,53000,402,980.0,1067.0
2825,"McPherson County, Nebraska",204,6,12,5,6,3,5,5,31,117,31117,11,19,67,65,13,20,86,53,24,39,153,118,395,204,191,389,0,0,6,6,48125,75,287.0,302.0
2826,"Nance County, Nebraska",1779,109,159,86,89,99,116,54,31,125,31125,226,293,526,309,203,270,520,414,429,563,1046,723,3544,1779,1765,3504,14,0,5,99,49032,775,1621.0,1828.0
2827,"Stanton County, Nebraska",2984,185,207,127,194,209,222,135,31,167,31167,348,556,857,486,334,483,837,559,682,1039,1694,1045,5957,2984,2973,5763,87,29,36,330,63986,1178,2801.0,3165.0
2828,"Valley County, Nebraska",2048,130,126,73,120,140,117,89,31,175,31175,225,323,527,501,263,305,558,566,488,628,1085,1067,4206,2048,2158,4116,20,0,12,143,55324,969,2205.0,2333.0
2829,"Churchill County, Nevada",12284,882,718,468,795,835,709,376,32,1,32001,1823,2219,3231,2190,1696,1896,3328,2340,3519,4115,6559,4530,24259,12284,11975,19787,599,676,983,3376,57824,4468,10938.0,12503.0
2830,"Douglas County, Nevada",24169,872,1358,850,803,1189,1149,830,32,5,32005,2643,3704,7021,6601,2361,3541,7500,6590,5004,7245,14521,13191,48132,24169,23963,42904,364,879,1520,6108,66810,9437,27885.0,33537.0
2831,"Pershing County, Nevada",4243,124,66,103,215,205,157,50,32,27,32027,670,1184,1312,594,224,385,694,442,894,1569,2006,1036,6615,4243,2372,5305,253,70,439,1617,50491,1437,1982.0,2232.0
2832,"Eureka County, Nevada",939,66,45,12,40,46,121,22,32,11,32011,64,188,310,178,68,126,340,157,132,314,650,335,1859,939,920,1744,1,13,7,81,67105,414,854.0,942.0
2833,"Humboldt County, Nevada",8680,584,456,350,659,529,759,381,32,13,32013,1063,1954,2272,1158,1169,1564,1986,1101,2232,3518,4258,2259,16828,8680,8148,14531,109,109,777,4547,67756,2855,6433.0,7324.0
2834,"White Pine County, Nevada",5688,271,229,232,242,193,338,133,32,33,32033,942,1342,1524,797,426,791,1065,803,1368,2133,2589,1600,9679,5688,3991,8237,571,87,130,1565,60827,2181,3773.0,4177.0
2835,"Elko County, Nevada",27216,1971,2228,1282,1794,2038,1980,1109,32,7,32007,4572,5494,6895,2844,3987,5017,6257,2899,8559,10511,13152,5743,52297,27216,25081,44789,270,584,2487,12751,81232,8039,18559.0,20575.0
2836,"Nye County, Nevada",22543,903,1121,774,1117,989,1021,653,32,23,32023,2594,3013,6506,6614,1947,3138,6413,6559,4541,6151,12919,13173,44380,22543,21837,36858,846,745,3327,6513,47300,7909,19595.0,22857.0
2837,"Storey County, Nevada",2108,137,74,87,76,113,104,38,32,29,32029,194,371,575,584,201,243,547,558,395,614,1122,1142,3988,2108,1880,3494,67,37,9,129,66292,861,2558.0,2870.0
2838,"Clark County, Nevada",1089228,70749,72879,43140,67334,68192,72872,41419,32,3,32003,176102,232570,272730,147190,170976,229395,274292,168296,347078,461965,547022,315486,2182004,1089228,1092776,1312652,255174,212385,249921,679381,59340,373776,767156.0,852228.0
2839,"Lyon County, Nevada",27450,1410,1760,1033,1561,1857,1381,1152,32,19,32019,3517,4917,7515,5686,3338,4582,7373,5686,6855,9499,14888,11372,54380,27450,26930,46265,458,707,3193,9306,56875,8753,23762.0,29392.0
2840,"Cheshire County, New Hampshire",37138,1737,1884,1264,1721,1782,2059,1175,33,5,33005,6754,6131,10563,6738,6931,6094,11161,7981,13685,12225,21724,14719,76042,37138,38904,72352,682,959,226,1408,64751,18682,41895.0,44200.0
2841,"Grafton County, New Hampshire",44210,1872,2237,1434,1840,1893,2113,1307,33,9,33009,9015,7108,12143,8384,8413,7439,12982,9580,17428,14547,25125,17964,89777,44210,45567,82814,1075,3331,264,2150,63389,23337,51191.0,53989.0
2842,"Rockingham County, New Hampshire",151844,7259,8162,6141,6698,8322,8475,5823,33,15,33015,21659,26722,48438,24141,19553,27040,49975,28629,41212,53762,98413,52770,306359,151844,154515,290182,2550,6321,1921,9161,93756,77817,181434.0,198952.0
2843,"Sullivan County, New Hampshire",21432,1034,1104,808,964,951,1336,763,33,19,33019,2933,3594,6617,4138,2467,3604,6777,4810,5400,7198,13394,8948,43104,21432,21672,41511,341,345,37,674,61312,11316,22683.0,24365.0
2844,"Hillsborough County, New Hampshire",205394,11130,11667,8114,10536,11034,12462,7693,33,11,33011,33424,39253,60708,28170,31133,38662,61389,34732,64557,77915,122097,62902,413035,205394,207641,369394,12025,16694,3835,27970,81460,96019,214157.0,230531.0
2845,"Coos County, New Hampshire",16723,630,733,575,639,584,838,479,33,7,33007,2375,2894,5258,3490,1607,2279,4762,3830,3982,5173,10020,7320,31741,16723,15018,29822,824,168,119,935,47117,7240,15627.0,16507.0
2846,"Carroll County, New Hampshire",23882,1027,1142,876,870,1088,976,709,33,3,33003,2657,3257,7569,6276,2448,3492,7968,6705,5105,6749,15537,12981,48138,23882,24256,46773,226,327,44,713,63153,12390,29616.0,33111.0
2847,"Mercer County, New Jersey",179846,10655,10965,7099,10221,9933,11383,6940,34,21,34021,32753,34874,48667,23325,32298,34374,51311,31616,65051,69248,99978,54941,367922,179846,188076,231533,76166,40882,10723,64504,81057,89429,156529.0,158252.0
2848,"Cumberland County, New Jersey",77686,4949,5134,3025,4716,4828,5379,2891,34,11,34011,12881,17307,19275,9864,10771,13626,19197,12812,23652,30933,38472,22676,151906,77686,74220,103397,29551,2189,9237,46643,54149,25268,54004.0,40103.0
2849,"Somerset County, New Jersey",161195,8690,9288,7323,8328,9685,10538,7119,34,35,34035,22792,29994,49160,21629,21557,31290,51365,28761,44349,61284,100525,50390,329838,161195,168643,218626,32147,58305,12227,48326,113611,101456,157092.0,160774.0
2850,"Ocean County, New Jersey",287757,21605,19711,11509,20393,18945,19208,10899,34,29,34029,39683,45912,72307,56801,37989,45536,78609,77079,77672,91448,150916,133880,596415,287757,308658,542186,18465,11175,13702,54932,70909,125938,274362.0,310380.0
2851,"Atlantic County, New Jersey",128791,7518,7842,5288,7323,7492,8207,4945,34,1,34001,20715,21883,36459,20616,20206,23075,40025,26041,40921,44958,76484,46657,266105,128791,137314,174978,38907,21006,20316,50150,62110,52681,117291.0,114599.0
2852,"Middlesex County, New Jersey",407170,24645,25160,16096,23423,25206,24488,15130,34,23,34023,67642,85833,108867,52597,65085,84090,112712,68616,132727,169923,221579,121213,825920,407170,418750,478174,85481,198426,37309,174747,89533,241848,326102.0,213777.0
2853,"Salem County, New Jersey",30823,1749,2013,1308,1692,1933,1846,1172,34,33,34033,4621,5384,8708,5108,4361,5414,9320,6429,8982,10798,18028,11537,62990,30823,32167,50417,8340,677,1281,5676,66842,12888,29494.0,29905.0
2854,"Cape May County, New Jersey",45495,2247,2195,1488,2003,2225,2274,1483,34,9,34009,6595,6642,13078,10774,5492,6633,14196,13285,12087,13275,27274,24059,93086,45495,47591,85095,4187,864,1062,7153,67074,22749,48722.0,54945.0
2855,"Camden County, New Jersey",244647,15772,16611,10242,15200,15179,16445,9766,34,7,34007,39188,48084,65181,32926,38470,50488,71678,44865,77658,98572,136859,77791,506738,244647,262091,322202,97617,29048,40537,84972,70451,105421,226592.0,205125.0
2856,"Union County, New Jersey",270127,17850,19095,11247,17248,17615,18440,10823,34,39,34039,41659,55605,73412,33244,40218,56428,77753,45381,81877,112033,151165,78625,554033,270127,283906,304231,117292,28328,86716,174998,80198,119246,221975.0,122777.0
2857,"Hudson County, New Jersey",333123,24008,18628,10055,22955,19194,15827,9538,34,17,34017,63304,91914,75136,32701,59707,85025,78731,45946,123011,176939,153867,78647,670046,333123,336923,366901,81275,101912,91585,288647,71189,180247,219375.0,189521.0
2858,"Hunterdon County, New Jersey",62104,2537,3127,2987,2539,3020,3811,2708,34,19,34019,9311,9148,20553,10365,7351,9464,21896,11930,16662,18612,42449,22295,124823,62104,62719,113022,3268,5145,1329,8166,115379,34926,70836.0,78998.0
2859,"Morris County, New Jersey",242146,12671,14559,10674,11989,13510,15681,10201,34,27,34027,34726,43777,73311,36168,33008,44316,76217,46311,67734,88093,149528,82479,493379,242146,251233,402269,17023,50794,11363,65683,115527,140621,250416.0,148759.0
2860,"Hidalgo County, New Mexico",2130,126,130,45,139,156,129,99,35,23,35023,355,349,574,426,247,309,604,484,602,658,1178,910,4297,2130,2167,4031,54,0,91,2497,42526,722,1872.0,1948.0
2861,"McKinley County, New Mexico",34986,2721,2984,1734,2675,2774,3165,1696,35,31,35031,6433,6538,7783,3560,6488,6730,8874,5050,12921,13268,16657,8610,72438,34986,37452,10426,474,829,3010,10320,33834,5056,21703.0,26193.0
2862,"Sandoval County, New Mexico",69943,4038,4680,3190,3777,4726,4938,2908,35,43,35043,10039,13423,18087,11108,9669,13842,19609,13292,19708,27265,37696,24400,142704,69943,72761,102859,3327,1976,10373,55525,63802,25690,61690.0,76215.0
2863,"Grant County, New Mexico",13652,786,791,529,693,676,791,466,35,17,35017,1763,2122,3219,3596,1745,2245,3650,3751,3508,4367,6869,7347,27669,13652,14017,25630,275,175,570,13969,37843,5923,12811.0,14435.0
2864,"Curry County, New Mexico",25956,2126,1755,1044,1961,1861,1585,890,35,9,35009,6218,5280,4879,2670,4330,4609,5119,3421,10548,9889,9998,6091,49732,25956,23776,33022,2520,643,10142,20971,45092,6511,13370.0,15077.0
2865,"Lee County, Texas",8530,520,436,452,540,479,596,263,48,287,48287,1291,1564,2255,1514,1040,1670,2240,1700,2331,3234,4495,3214,17058,8530,8528,13945,1917,182,846,4040,54744,2918,6535.0,8075.0
2866,"Tarrant County, Texas",1002709,73992,74209,46323,70567,76698,74481,45133,48,439,48439,172219,210573,244550,98602,174595,221489,256962,127136,346814,432062,501512,225738,2049770,1002709,1047061,1374182,338378,111274,146177,590485,67700,371798,668514.0,830104.0
2867,"Anderson County, Texas",35201,1422,1739,1055,1623,1389,1579,901,48,1,48001,5944,10258,9395,3848,2995,3834,5858,4430,8939,14092,15253,8278,57810,35201,22609,42217,12124,321,1926,10283,43455,9915,16977.0,19155.0
2868,"Ellis County, Texas",85705,5956,6474,4252,5709,6274,6615,4096,48,139,48139,13515,16498,22026,9802,12920,17740,22585,12128,26435,34238,44611,21930,173772,85705,88067,141636,17580,1120,5428,45577,76871,29555,63673.0,85566.0
2869,"Jackson County, Texas",7316,544,444,291,466,542,633,301,48,239,48239,1026,1539,1752,1168,997,1293,1859,1409,2023,2832,3611,2577,14816,7316,7500,12912,1010,162,466,4905,62806,2248,5302.0,6210.0
2870,"Kerr County, Texas",25027,1342,1289,967,1310,1362,1338,857,48,265,48265,3520,3612,6219,6541,3499,3978,6989,7483,7019,7590,13208,14024,51843,25027,26816,45818,765,431,3185,13964,55990,10105,23297.0,27738.0
2871,"Milam County, Texas",12270,735,675,814,784,717,889,470,48,331,48331,1696,1900,3158,2325,1541,2014,3372,2713,3237,3914,6530,5038,24770,12270,12500,21121,2582,142,385,6546,47902,4082,8664.0,10523.0
2872,"Comanche County, Texas",6798,389,394,320,381,382,450,227,48,93,48093,883,1045,1774,1517,793,1060,1708,1730,1676,2105,3482,3247,13529,6798,6731,12684,177,82,341,3777,53516,2400,5237.0,6084.0
2873,"Falls County, Texas",8127,527,447,226,516,546,483,317,48,145,48145,1391,1274,2162,1490,1336,2015,2327,1605,2727,3289,4489,3095,17272,8127,9145,12433,4233,82,257,4000,39497,2763,5248.0,6133.0
2874,"Brooks County, Texas",3807,243,255,177,335,273,211,131,48,47,48047,1145,775,484,463,561,467,778,578,1706,1242,1262,1041,7141,3807,3334,6450,48,0,448,6646,28333,848,2596.0,2484.0
2875,"Austin County, Texas",14682,896,904,598,890,1092,991,665,48,15,48015,2098,2430,4002,2658,2018,2467,4040,2919,4116,4897,8042,5577,29764,14682,15082,23146,2684,111,2952,7989,66206,5242,12274.0,14368.0
2876,"Kenedy County, Texas",280,59,0,4,41,15,0,0,48,261,48261,47,17,63,41,7,67,55,103,54,84,118,144,568,280,288,567,0,0,1,538,38021,8,186.0,194.0
2877,"Colorado County, Texas",10590,662,590,345,728,720,621,412,48,89,48089,1566,1697,2690,2127,1357,1528,2801,2467,2923,3225,5491,4594,21224,10590,10634,15520,2740,5,2488,6310,52559,3161,8513.0,9912.0
2878,"San Patricio County, Texas",33774,2547,2468,1601,2315,2318,2553,1495,48,409,48409,5469,6611,7737,4536,4970,6382,7947,5254,10439,12993,15684,9790,67008,33774,33234,61845,1171,676,1465,38724,56556,10604,21656.0,25850.0
2879,"Randall County, Texas",65721,4330,4527,2811,4334,4723,4231,2582,48,381,48381,11593,13689,15339,8733,11496,13474,16539,10926,23089,27163,31878,19659,134026,65721,68305,118890,3678,2589,3229,28991,68261,26079,54305.0,69973.0
2880,"San Saba County, Texas",3077,122,176,147,188,113,230,99,48,411,48411,525,537,774,627,465,396,668,755,990,933,1442,1382,5991,3077,2914,5101,121,9,468,1803,45083,847,2357.0,2602.0
2881,"Schleicher County, Texas",1505,118,113,73,99,108,123,53,48,413,48413,181,338,340,240,232,220,323,320,413,558,663,560,2983,1505,1478,1853,16,0,1098,1580,53229,384,1059.0,1158.0
2882,"Zavala County, Texas",6221,439,622,276,451,486,483,285,48,507,48507,1266,1217,1158,729,973,935,1269,936,2239,2152,2427,1665,12039,6221,5818,11469,40,11,432,11304,34459,1906,3396.0,4379.0
2883,"Calhoun County, Texas",11082,737,651,471,709,799,661,431,48,57,48057,1747,2007,2770,1803,1532,1875,2613,1966,3279,3882,5383,3769,21668,11082,10586,18645,597,1183,351,10589,58776,3551,6965.0,7853.0
2884,"Foard County, Texas",632,6,28,37,44,0,46,36,48,155,48155,64,92,195,176,70,83,195,169,134,175,390,345,1275,632,643,1048,29,0,68,284,43625,246,513.0,551.0
2885,"Goliad County, Texas",3756,169,240,133,123,261,255,136,48,175,48175,461,546,1079,807,474,585,1118,857,935,1131,2197,1664,7565,3756,3809,6119,445,55,910,2712,60690,1122,3708.0,3978.0
2886,"Hamilton County, Texas",4164,279,163,147,213,277,186,154,48,193,48193,587,682,1066,928,502,630,1092,1114,1089,1312,2158,2042,8332,4164,4168,7939,66,0,98,1062,50825,1793,3620.0,4347.0
2887,"Mitchell County, Texas",5179,214,336,205,222,231,142,185,48,335,48335,1510,1224,961,576,508,518,798,740,2018,1742,1759,1316,8523,5179,3344,6824,840,37,452,3399,51492,1244,2196.0,2579.0
2888,"Titus County, Texas",16066,1242,1438,813,1277,1380,1262,748,48,449,48449,2689,2730,3812,2069,2735,2919,3761,2492,5424,5649,7573,4561,32640,16066,16574,22968,2926,357,5341,14048,50196,4417,9419.0,10530.0
2889,"Lavaca County, Texas",9697,580,710,363,622,739,697,395,48,285,48285,1309,1535,2488,2073,1218,1534,2530,2589,2527,3069,5018,4662,20021,9697,10324,15747,1281,94,2266,3785,54403,3675,8661.0,10195.0
2890,"Terry County, Texas",6420,529,476,108,510,528,419,423,48,445,48445,1183,1334,1516,817,837,1014,1305,1072,2020,2348,2821,1889,12528,6420,6108,11418,609,2,290,6891,44627,1903,3355.0,3608.0
2891,"Wise County, Texas",33406,2151,2168,1553,2079,2204,2316,1408,48,497,48497,4806,6172,9241,4733,4606,6027,9126,5118,9412,12199,18367,9851,66290,33406,32884,61993,948,338,1036,12822,64536,11909,24776.0,32297.0
2892,"Matagorda County, Texas",18349,1332,1428,735,1280,1056,1582,823,48,321,48321,2867,3125,4742,2863,2609,3069,4861,3145,5476,6194,9603,6008,36774,18349,18425,25145,3813,710,6181,15612,48913,5247,12196.0,13710.0
2893,"Pecos County, Texas",8966,472,738,268,543,558,518,328,48,371,48371,1477,2228,2339,981,1038,1274,1559,1031,2515,3502,3898,2012,15815,8966,6849,13059,556,96,1675,10877,52397,2760,4185.0,4668.0
2894,"Rockwall County, Texas",47995,3114,3769,2560,2886,3316,4266,2396,48,397,48397,6504,10151,12544,5268,6124,10504,13202,6486,12628,20655,25746,11754,97175,47995,49180,82587,6148,2642,2305,17138,100920,19472,39948.0,57792.0
2895,"Taylor County, Texas",66757,5115,4664,2552,4954,4366,4708,2750,48,441,48441,15316,12278,13760,8299,14843,12392,14917,11183,30159,24670,28677,19482,136870,66757,70113,104989,10946,3002,13474,33404,53143,21258,45759.0,54924.0
2896,"Throckmorton County, Texas",658,32,16,12,45,33,25,39,48,447,48447,81,94,203,192,86,113,227,210,167,207,430,402,1436,658,778,1404,14,0,4,190,40000,298,808.0,899.0
2897,"Walker County, Texas",42217,1611,1670,882,1454,1278,1818,750,48,471,48471,10664,10037,11549,4466,9204,4692,6187,4721,19868,14729,17736,9187,72321,42217,30104,52800,16780,920,462,12973,43742,14734,19796.0,23641.0
2898,"Wood County, Texas",22059,1214,1275,788,931,1211,1223,773,48,499,48499,2983,3223,5857,5519,2499,3296,6035,6339,5482,6519,11892,11858,44366,22059,22307,39622,2224,286,1153,4435,53394,7715,18727.0,22665.0
2899,"Aransas County, Texas",11904,555,605,401,581,624,681,503,48,7,48007,1563,1601,3300,3240,1408,1679,3611,3471,2971,3280,6911,6711,24462,11904,12558,22115,354,489,471,6721,45137,4424,10512.0,12241.0
2900,"Cochran County, Texas",1495,112,129,84,100,109,92,62,48,79,48079,225,308,318,226,208,282,310,229,433,590,628,455,2887,1495,1392,2565,144,0,105,1695,40962,377,901.0,996.0
2901,"Coke County, Texas",1647,35,139,101,58,34,151,43,48,81,48081,148,231,459,404,149,297,387,537,297,528,846,941,3303,1647,1656,2971,32,0,251,711,45000,617,1423.0,1794.0
2902,"Coryell County, Texas",37556,2602,2588,1264,2669,2199,2519,1219,48,99,48099,10021,8682,6834,3196,7747,9073,8090,4208,17768,17755,14924,7404,75280,37556,37724,54825,10234,1546,823,13761,52893,10098,18253.0,23425.0
2903,"Hemphill County, Texas",2032,106,174,116,131,145,261,127,48,211,48211,202,471,512,250,175,395,451,277,377,866,963,527,3994,2032,1962,3629,40,1,229,1391,70625,684,1695.0,1720.0
2904,"Moore County, Texas",11218,994,1226,495,916,984,774,456,48,341,48341,1956,2290,2293,1065,1720,1929,2184,1218,3676,4219,4477,2283,21399,11218,10181,16420,803,1463,2066,11996,54871,2532,5284.0,5502.0
2905,"Potter County, Texas",61773,4971,4926,2438,4494,4617,4430,2512,48,375,48375,10624,13427,14396,6447,9565,11059,13088,8136,20189,24486,27484,14583,119674,61773,57901,93546,12048,6469,2983,45859,42528,17092,28651.0,33242.0
2906,"San Augustine County, Texas",3969,205,157,120,213,172,262,205,48,405,48405,445,535,1139,1060,459,620,1262,1124,904,1155,2401,2184,8286,3969,4317,6111,1768,14,71,597,40353,1262,3569.0,3998.0
2907,"Shackelford County, Texas",1750,130,182,134,74,42,53,32,48,417,48417,192,281,419,287,250,232,518,345,442,513,937,632,3296,1750,1546,3158,7,8,31,380,46935,688,1504.0,1628.0
2908,"Starr County, Texas",31183,3156,3204,1682,3189,2710,2992,1741,48,427,48427,6099,5720,5718,3124,5802,5764,6625,4072,11901,11484,12343,7196,64078,31183,32895,61060,49,10,2674,63549,30387,6822,11740.0,17478.0
2909,"Upton County, Texas",1901,141,127,96,118,65,200,101,48,461,48461,264,370,516,277,158,332,450,334,422,702,966,611,3659,1901,1758,1648,220,26,1741,1966,52171,455,1347.0,1365.0
2910,"Brown County, Texas",18681,1057,1103,802,908,1116,1231,869,48,49,48049,2921,3193,4915,3389,2736,3301,5014,3999,5657,6494,9929,7388,37855,18681,19174,34554,1426,270,519,8422,48365,7158,14026.0,15940.0
2911,"Hall County, Texas",1534,74,92,56,31,85,126,65,48,191,48191,228,191,442,302,189,246,393,379,417,437,835,681,3048,1534,1514,2376,197,8,309,1060,34673,434,1091.0,1165.0
2912,"Franklin County, Texas",5245,321,436,215,275,259,436,316,48,159,48159,693,787,1392,1069,664,861,1405,1255,1357,1648,2797,2324,10716,5245,5471,9213,473,5,602,1550,53783,1952,4380.0,5000.0
2913,"Frio County, Texas",11883,655,744,561,640,522,600,450,48,163,48163,3453,2772,1963,1165,1330,1362,1781,1303,4783,4134,3744,2468,19871,11883,7988,16342,718,170,2250,15753,46729,2498,4400.0,5264.0
2914,"Lampasas County, Texas",10426,540,430,568,580,455,874,375,48,281,48281,1431,1853,3007,1787,1169,1826,3030,2127,2600,3679,6037,3914,20862,10426,10436,18212,961,240,434,4052,60772,3471,8205.0,10373.0
2915,"Orleans County, Vermont",13512,705,667,483,590,691,761,493,50,19,50019,1817,2345,3904,2771,1580,2259,3839,3176,3397,4604,7743,5947,26901,13512,13389,25925,150,77,76,405,49168,6563,12047.0,14103.0
2916,"Grand Isle County, Vermont",3489,145,194,127,157,206,141,113,50,13,50013,480,535,1157,700,417,572,1226,701,897,1107,2383,1401,7022,3489,3533,6628,58,36,6,140,71587,1944,4110.0,4863.0
2917,"Chittenden County, Vermont",79812,3978,4025,2864,3678,3641,4197,2439,50,7,50007,19279,14689,20380,10278,19206,14779,21365,13529,38485,29468,41745,23807,162646,79812,82834,146712,4445,6519,845,3813,73647,40745,83418.0,81662.0
2918,"Lamoille County, Vermont",12686,653,799,440,635,692,813,420,50,15,50015,2118,2389,3478,2094,1950,2346,3634,2142,4068,4735,7112,4236,25318,12686,12632,24145,308,205,39,455,64003,6725,12762.0,14951.0
2919,"Franklin County, Vermont",24403,1468,1745,1019,1485,1737,1205,974,50,11,50011,3508,4637,7147,3553,3353,4655,7214,4090,6861,9292,14361,7643,49116,24403,24713,46504,261,271,245,774,65485,11573,21411.0,25820.0
2920,"Caledonia County, Vermont",15192,714,854,581,676,677,921,547,50,5,50005,2396,2498,4338,2845,1988,2444,4582,3207,4384,4942,8920,6052,30234,15192,15042,28959,289,156,124,483,50563,7979,14075.0,16186.0
2921,"Windham County, Vermont",20800,1003,1203,708,943,1172,1040,690,50,25,50025,3003,3235,6377,4311,2634,3610,6867,5067,5637,6845,13244,9378,42823,20800,22023,40570,502,432,111,999,51985,11783,22635.0,26078.0
2922,"Bennington County, Vermont",17487,939,858,671,765,992,755,602,50,3,50003,2602,2479,5036,3679,2645,2612,5519,4369,5247,5091,10555,8048,35746,17487,18259,34210,247,360,126,717,56183,9114,17381.0,20340.0
2923,"Addison County, Vermont",18302,778,860,589,750,933,736,625,50,1,50001,3509,2847,5320,3329,3395,2966,5429,3746,6904,5813,10749,7075,36882,18302,18580,34625,541,663,240,852,68825,9874,19031.0,22029.0
2924,"Essex County, Vermont",3121,140,171,114,124,130,169,102,50,9,50009,338,432,980,802,308,444,1037,765,646,876,2017,1567,6200,3121,3079,5984,61,30,16,86,44349,1670,2925.0,3288.0
2925,"Eddy County, New Mexico",29137,2151,1985,1232,2084,2006,2097,1286,35,15,35015,4737,5819,6945,3787,4506,5376,6773,4467,9243,11195,13718,8254,57732,29137,28595,52019,906,265,2720,28363,65328,10113,19667.0,23222.0
2926,"Mora County, New Mexico",2201,76,96,19,43,83,44,88,35,33,35033,399,217,741,576,353,212,709,803,752,429,1450,1379,4536,2201,2335,2991,2,0,1501,3696,28446,594,2441.0,2683.0
2927,"San Juan County, New Mexico",62677,4410,4923,2853,4225,4538,5033,2891,35,45,35045,10060,12172,15019,8083,9752,12029,15424,9946,19812,24201,30443,18029,126515,62677,63838,66160,1041,984,4270,25668,50518,14970,46110.0,52284.0
2928,"Benton County, Mississippi",4046,160,279,159,154,187,410,168,28,9,28009,797,579,1230,590,443,910,1074,840,1240,1489,2304,1430,8232,4046,4186,5051,2813,0,104,214,36258,1135,4013.0,4257.0
2929,"Franklin County, Mississippi",3696,220,161,131,208,182,442,140,28,37,28037,506,664,993,671,474,685,1088,818,980,1349,2081,1489,7733,3696,4037,4903,2782,4,2,21,40219,1138,4290.0,4431.0
2930,"Coahoma County, Mississippi",10743,953,832,500,949,875,814,534,28,27,28027,1935,1687,2506,1432,2058,2195,3119,1968,3993,3882,5625,3400,23255,10743,12512,4860,18050,115,25,86,29121,2396,8912.0,7136.0
2931,"Jasper County, Mississippi",8035,532,549,334,489,456,596,283,28,61,28061,1188,1276,2169,1479,1214,1386,2279,1767,2402,2662,4448,3246,16505,8035,8470,7379,8964,0,72,75,35872,2139,8475.0,8642.0
2932,"Jones County, Mississippi",33384,2569,2805,1452,2260,2246,2399,1368,28,67,28067,5255,5853,8379,4837,5255,6378,8676,6386,10510,12231,17055,11223,68352,33384,34968,46881,20077,225,277,3073,41775,10502,28352.0,26492.0
2933,"Walthall County, Mississippi",7214,521,527,434,331,480,446,185,28,147,28147,1075,1224,1788,1202,998,1319,1940,1564,2073,2543,3728,2766,14477,7214,7263,7665,6706,15,63,119,30961,2361,6919.0,0.0
2934,"Monroe County, Mississippi",17002,1077,1173,689,1005,912,1382,719,28,95,28095,2507,3000,4533,2877,2520,3189,5050,3894,5027,6189,9583,6771,35673,17002,18671,24288,11132,31,19,450,42354,5747,15884.0,14461.0
2935,"Pontotoc County, Mississippi",15292,1087,1253,633,1143,1253,1192,812,28,115,28115,2315,2866,4049,2053,2295,2993,4050,2588,4610,5859,8099,4641,31618,15292,16326,24564,5068,25,1539,2171,44759,4965,12984.0,14215.0
2936,"Holmes County, Mississippi",8483,670,732,397,535,685,565,387,28,51,28051,1686,1369,1927,1075,1607,1611,2363,1501,3293,2980,4290,2576,17737,8483,9254,2749,14903,12,54,30,21504,1221,8076.0,6542.0
2937,"Amite County, Mississippi",6013,307,378,261,366,354,357,202,28,5,28005,805,939,1700,1281,729,875,1971,1545,1534,1814,3671,2826,12412,6013,6399,7119,5202,23,30,0,33981,2062,7050.0,5974.0
2938,"Madison County, Mississippi",49973,3325,3917,2276,3288,3794,3654,2244,28,89,28089,7788,9895,13141,5828,8025,11408,14597,7579,15813,21303,27738,13407,104562,49973,54589,59828,39731,2699,1253,3133,71824,23339,49802.0,45832.0
2939,"Calhoun County, Mississippi",6917,418,340,287,441,326,622,297,28,13,28013,952,1217,1840,1150,1008,1260,2115,1513,1960,2477,3955,2663,14499,6917,7582,9459,3968,34,766,873,37263,1893,6396.0,6536.0
2940,"Marion County, Mississippi",12102,705,709,430,742,879,801,544,28,91,28091,1911,2244,3247,1910,1750,2257,3325,2590,3661,4501,6572,4500,24990,12102,12888,16308,8140,131,332,402,32090,3673,11693.0,11338.0
2941,"Tishomingo County, Mississippi",9544,588,638,392,491,567,634,338,28,141,28141,1339,1555,2677,1773,1372,1646,2632,2217,2711,3201,5309,3990,19441,9544,9897,18680,516,5,18,616,37681,3571,8371.0,9057.0
2942,"Wayne County, Mississippi",10074,821,689,561,569,586,786,278,28,153,28153,1531,1669,2563,1502,1558,1884,2725,1913,3089,3553,5288,3415,20373,10074,10299,11695,8359,26,115,132,37706,3286,9599.0,9988.0
2943,"Greene County, Mississippi",8156,295,382,305,346,409,280,233,28,41,28041,1431,1998,2470,876,816,994,1459,952,2247,2992,3929,1828,13645,8156,5489,10021,3538,0,3,163,49677,2085,5369.0,5748.0
2944,"Marshall County, Mississippi",17559,1023,1112,665,997,979,1165,660,28,93,28093,2917,3141,5056,2647,2964,2915,4964,3396,5881,6056,10020,6043,35599,17559,18040,17616,17017,0,637,1315,42233,4860,14839.0,13064.0
2945,"Quitman County, Mississippi",3362,220,252,140,228,229,239,131,28,119,28119,555,534,910,495,568,674,1057,699,1123,1208,1967,1194,7187,3362,3825,1939,5176,16,13,88,25283,615,3365.0,3211.0
2946,"Pearl River County, Mississippi",27311,1695,1773,1107,1387,1623,1863,1093,28,109,28109,4459,4511,7232,4661,4060,4746,7633,5503,8519,9257,14865,10164,55219,27311,27908,46246,7055,137,323,1709,46901,8760,21883.0,23656.0
2947,"Leake County, Mississippi",11746,701,785,810,695,715,641,454,28,79,28079,1938,2079,2636,1528,1510,2049,2896,2086,3448,4128,5532,3614,22792,11746,11046,11677,9555,117,47,1059,37096,2659,8449.0,8407.0
2948,"Neshoba County, Mississippi",13988,1005,1159,643,1023,1083,1208,752,28,99,28099,2092,2422,3420,2016,2203,2792,3698,2585,4295,5214,7118,4601,29332,13988,15344,17593,6145,159,55,626,37987,3583,10553.0,11698.0
2949,"Rankin County, Mississippi",73629,4636,4969,3254,4534,4388,5492,3119,28,121,28121,11089,15772,18795,9690,11351,17046,20308,12810,22440,32818,39103,22500,152677,73629,79048,115371,31723,1765,1586,4201,65996,29685,62768.0,53400.0
2950,"Washington County, Mississippi",21501,1712,1566,1042,1742,1585,1645,1022,28,151,28151,3488,3515,5450,3008,3652,4256,6565,4089,7140,7771,12015,7097,46057,21501,24556,11807,33235,260,432,745,29705,5370,16825.0,10514.0
2951,"Lawrence County, Mississippi",6170,385,413,297,402,385,495,219,28,77,28077,772,1160,1653,995,860,1176,1708,1218,1632,2336,3361,2213,12633,6170,6463,8215,4109,28,119,116,41914,2058,6364.0,6564.0
2952,"Perry County, Mississippi",5847,354,414,246,365,346,398,238,28,111,28111,889,941,1688,895,899,1160,1580,1173,1788,2101,3268,2068,12006,5847,6159,9488,2379,18,0,181,42469,2093,5432.0,5825.0
2953,"Chickasaw County, Mississippi",8291,681,573,343,570,526,726,342,28,17,28017,1345,1433,2138,1245,1354,1455,2280,1649,2699,2888,4418,2894,17193,8291,8902,8651,7616,33,624,841,36548,2268,7890.0,8143.0
2954,"Carroll County, Mississippi",5082,287,280,149,164,256,412,127,28,15,28015,731,749,1539,1084,580,754,1478,1217,1311,1503,3017,2301,10070,5082,4988,6499,3499,0,0,24,46052,1372,5528.0,4509.0
2955,"George County, Mississippi",12034,901,850,580,837,967,788,700,28,39,28039,2087,2230,3000,1668,1797,1962,2983,1849,3884,4192,5983,3517,23917,12034,11883,21255,1920,107,207,683,47292,3888,9891.0,10940.0
2956,"Grenada County, Mississippi",10047,680,750,447,658,693,693,393,28,43,28043,1572,1763,2565,1566,1609,1929,2958,2108,3181,3692,5523,3674,21088,10047,11041,11577,9161,46,16,127,40122,3238,10513.0,7838.0
2957,"Jefferson County, Mississippi",3534,256,203,121,196,221,319,149,28,63,28063,620,756,889,474,510,616,1044,636,1130,1372,1933,1110,7225,3534,3691,959,6198,43,8,522,25019,750,3860.0,3907.0
2958,"Newton County, Mississippi",10042,657,599,429,682,779,858,475,28,101,28101,1782,1717,2455,1468,1807,1995,2747,1975,3589,3712,5202,3443,21360,10042,11318,13115,6515,111,220,408,35958,2870,9438.0,8678.0
2959,"Prentiss County, Mississippi",12146,821,927,432,739,843,860,456,28,117,28117,2192,2280,3044,1810,2055,2160,3359,2637,4247,4440,6403,4447,25255,12146,13109,21115,2533,554,107,380,39256,3791,9872.0,10539.0
2960,"Sharkey County, Mississippi",2036,121,253,90,96,119,177,115,28,125,28125,331,264,514,361,317,396,708,440,648,660,1222,801,4404,2036,2368,1104,3284,0,11,5,29394,507,2190.0,2157.0
2961,"Choctaw County, Mississippi",4158,274,278,219,150,324,202,80,28,19,28019,549,680,1098,772,541,702,1121,999,1090,1382,2219,1771,8277,4158,4119,5611,2566,2,13,49,36777,1431,4065.0,4175.0
2962,"Hancock County, Mississippi",22974,1390,1350,1063,1239,1242,1351,806,28,45,28045,3099,3944,6509,4209,3055,4115,7124,5055,6154,8059,13633,9264,46961,22974,23987,41108,3765,281,269,1794,48119,8410,17637.0,17403.0
2963,"Itawamba County, Mississippi",11835,663,761,519,588,605,725,391,28,57,28057,2146,1973,3084,1827,2045,2036,3004,2233,4191,4009,6088,4060,23462,11835,11627,21363,1709,6,106,376,44567,3277,9737.0,10743.0
2964,"Issaquena County, Mississippi",841,61,18,12,31,42,19,4,28,55,28055,142,259,233,104,38,121,149,116,180,380,382,220,1361,841,520,514,839,0,8,18,24208,76,699.0,676.0
2965,"Jackson County, Mississippi",70281,4215,4417,3277,3890,4488,4830,2863,28,59,28059,10750,13106,18684,10218,10530,14030,19494,11970,21280,27136,38178,22188,142376,70281,72095,100751,30305,3434,3842,9242,51657,23496,49567.0,45486.0
2966,"Leflore County, Mississippi",13623,1134,1217,679,1059,1141,1208,596,28,83,28083,2544,2350,2946,1651,2701,2826,3684,2384,5245,5176,6630,4035,29222,13623,15599,7009,21683,176,264,773,26735,3132,11140.0,8178.0
2967,"Tunica County, Mississippi",4659,474,334,229,466,432,349,243,28,143,28143,755,1043,887,520,887,1169,1129,654,1642,2212,2016,1174,9988,4659,5329,1911,7838,140,25,96,39370,1191,3567.0,3494.0
2968,"Claiborne County, Mississippi",4262,274,168,198,272,221,337,164,28,21,28021,1098,612,945,625,1254,701,1051,827,2352,1313,1996,1452,9089,4262,4827,1028,7928,103,5,8,29338,1259,4272.0,2886.0
2969,"Harrison County, Mississippi",100358,6948,7864,4085,6567,6406,7181,3914,28,47,28047,18248,18999,24578,13312,16581,20481,26741,16273,34829,39480,51319,29585,204502,100358,104144,138940,50994,5813,1535,11193,47894,33959,63313.0,60941.0
2970,"Lauderdale County, Mississippi",37112,2364,2682,1618,2359,2449,2483,1448,28,75,28075,6286,6861,9250,5407,5911,6958,10305,7254,12197,13819,19555,12661,76279,37112,39167,41343,33333,505,352,1723,42534,10721,29506.0,30811.0
2971,"Lincoln County, Mississippi",16278,1022,1292,629,1145,1040,1199,805,28,85,28085,2423,3051,4327,2451,2503,3294,4771,3285,4926,6345,9098,5736,34320,16278,18042,23159,10957,165,0,152,42606,5374,15193.0,14247.0
2972,"Simpson County, Mississippi",12997,753,1089,567,776,669,1146,573,28,127,28127,2044,2347,3284,2033,1919,2469,3758,2581,3963,4816,7042,4614,26888,12997,13891,16625,9851,149,0,68,43850,3800,11419.0,10066.0
2973,"Winston County, Mississippi",8851,437,507,413,493,572,618,317,28,159,28159,1317,1555,2345,1557,1201,1589,2507,2081,2518,3144,4852,3638,18229,8851,9378,9197,8553,6,57,234,34724,2487,8881.0,9184.0
2974,"Attala County, Mississippi",8718,585,601,362,600,524,856,417,28,7,28007,1288,1395,2228,1536,1260,1595,2493,1974,2548,2990,4721,3510,18437,8718,9719,9916,7792,44,318,377,33767,2393,8256.0,8832.0
2975,"Lamar County, Mississippi",29581,2000,2274,1284,2050,2107,2348,1279,28,73,28073,4840,6293,7063,3608,5032,7201,7837,4534,9872,13494,14900,8142,61969,29581,32388,47370,12446,799,207,1682,60328,12306,24592.0,28082.0
2976,"Lee County, Mississippi",40571,2872,3121,1873,2905,2975,2969,1828,28,81,28081,6336,7859,10246,5178,6521,8686,11423,7194,12857,16545,21669,12372,85072,40571,44501,56904,25089,833,1094,2249,50559,13002,32913.0,31762.0
2977,"Tallahatchie County, Mississippi",7851,372,317,247,392,397,409,235,28,135,28135,1898,2092,1603,874,918,1138,1628,1190,2816,3230,3231,2064,14158,7851,6307,5013,7599,198,1250,1341,29864,1430,5870.0,4956.0
2978,"Smith County, Mississippi",7824,453,809,419,447,494,551,305,28,129,28129,1075,1248,2146,1335,1103,1460,2127,1698,2178,2708,4273,3033,16009,7824,8185,12129,3675,85,17,280,43105,2495,7627.0,7285.0
2979,"Warren County, Mississippi",22208,1551,1579,958,1392,1455,1630,1055,28,149,28149,3407,4034,5843,3275,3457,4517,6610,4195,6864,8551,12453,7470,46519,22208,24311,22470,22978,332,172,981,45113,7246,19416.0,21162.0
2980,"Clarke County, Mississippi",7373,437,384,231,465,509,488,404,28,23,28023,1099,1248,1968,1393,1101,1417,2259,1754,2200,2665,4227,3147,15770,7373,8397,10028,5592,0,50,102,43207,2527,7791.0,8277.0
2981,"Montgomery County, Mississippi",4686,145,330,156,456,272,346,213,28,97,28097,702,765,1309,910,679,880,1358,1178,1381,1645,2667,2088,10068,4686,5382,5324,4446,29,55,140,39840,1622,4996.0,4972.0
2982,"Oktibbeha County, Mississippi",24737,1320,1028,667,1248,1221,1065,685,28,105,28105,10251,3843,3831,2410,9108,3742,4654,3052,19359,7585,8485,5462,49512,24737,24775,28406,18312,1635,261,837,40453,7596,18124.0,19737.0
2983,"Washington County, Vermont",28845,1471,1618,997,1320,1294,1812,1025,50,23,50023,4815,5084,8292,5023,3860,5228,8909,6057,8675,10312,17201,11080,58350,28845,29505,55952,517,492,67,1135,62791,15484,31086.0,35304.0
2984,"Millard County, Utah",6602,577,468,341,448,547,612,325,49,27,49027,868,1154,1432,1072,798,1039,1407,1076,1666,2193,2839,2148,12854,6602,6252,11562,30,148,756,1662,62242,1842,5242.0,4887.0
2985,"Tooele County, Utah",33981,2876,3087,1915,2628,3186,3121,1877,49,45,49045,5053,7545,7089,2800,4973,7750,6705,3176,10026,15295,13794,5976,67397,33981,33416,60542,326,528,2913,8332,74562,9428,21829.0,29770.0
2986,"Washington County, Utah",81947,5786,6340,3943,5456,6388,5789,3740,49,53,49053,12473,14266,15818,16603,12135,14426,17897,18033,24608,28692,33715,34636,165811,81947,83864,150104,1156,1306,5761,17364,59839,24638,61963.0,88807.0
2987,"Kane County, Utah",3765,248,236,260,184,204,279,120,49,25,49025,441,656,869,823,457,596,1016,863,898,1252,1885,1686,7484,3765,3719,6976,15,48,126,350,47044,1467,3505.0,3869.0
2988,"Summit County, Utah",20964,1061,1230,1024,946,1537,1453,904,49,43,49043,3059,3899,6172,2467,2737,3852,6323,2387,5796,7751,12495,4854,41103,20964,20139,38221,326,724,819,4705,102958,9870,20641.0,18130.0
2989,"Grand County, Utah",4934,127,512,207,354,166,334,80,49,19,49019,718,1232,1036,853,668,1151,1102,851,1386,2383,2138,1704,9640,4934,4706,8935,31,155,0,994,51557,1942,4533.0,5027.0
2990,"Piute County, Utah",1016,58,33,63,50,54,63,24,49,31,49031,104,176,245,229,91,123,215,230,195,299,460,459,1866,1016,850,1823,3,0,29,47,42813,419,729.0,871.0
2991,"Rich County, Utah",1126,86,102,58,59,102,115,71,49,33,49033,141,127,216,284,194,242,259,221,335,369,475,505,2389,1126,1263,2245,0,0,144,256,57902,394,1109.0,1320.0
2992,"Wasatch County, Utah",16233,1325,1477,844,1098,1587,1229,846,49,51,49051,2259,3340,3606,1749,2105,3286,3568,1756,4364,6626,7174,3505,31708,16233,15475,29947,87,432,454,4232,85166,5214,12120.0,16456.0
2993,"Beaver County, Utah",3362,327,203,204,284,282,285,184,49,1,49001,473,610,709,467,403,579,682,456,876,1189,1391,923,6517,3362,3155,6103,0,19,163,780,55221,996,2491.0,3076.0
2994,"Box Elder County, Utah",27550,2283,2525,1448,2112,2536,2229,1344,49,3,49003,4279,5350,5664,3288,3777,5133,5710,3555,8056,10483,11374,6843,53946,27550,26396,50233,353,422,1414,5093,62233,8340,19735.0,26027.0
2995,"Iron County, Utah",25373,2021,2161,1166,2064,2264,1866,1219,49,21,49021,5730,4564,4690,3090,5834,4350,4908,3335,11564,8914,9598,6425,51213,25373,25840,47016,269,445,1078,4463,51807,7404,17654.0,23731.0
2996,"Sanpete County, Utah",15722,933,947,859,884,900,1238,695,49,39,49039,3267,3239,3266,1980,2985,2413,2914,2099,6252,5652,6180,4079,29850,15722,14128,26406,217,306,2007,2854,53838,4228,10164.0,12133.0
2997,"Sevier County, Utah",10881,741,917,634,774,1005,720,504,49,41,49041,1552,1993,2351,1641,1397,1973,2265,1761,2949,3966,4616,3402,21280,10881,10399,20160,137,10,420,1100,54799,3406,8654.0,9731.0
2998,"Weber County, Utah",126354,9949,10266,5919,9601,9403,10419,5807,49,57,49057,22609,27157,26858,13298,21475,25952,27061,15426,44084,53109,53919,28724,251498,126354,125144,224216,2745,2904,10407,46159,67244,39454,85039.0,108335.0
2999,"San Juan County, Utah",7625,564,688,443,637,669,609,382,49,37,49037,1351,1251,1648,954,1189,1309,1736,1146,2540,2560,3384,2100,15302,7625,7677,7422,33,77,47,870,45394,1641,5447.0,5243.0
3000,"Salt Lake County, Utah",569053,43954,44610,25901,42404,43714,41595,24614,49,35,49035,104307,130648,120958,54054,100546,124741,121348,65631,204853,255389,242306,119685,1133646,569053,564593,896437,21602,46123,105495,208061,74865,199495,418868.0,404685.0
3001,"Daggett County, Utah",348,0,18,12,24,22,28,9,49,9,49009,50,60,142,44,48,27,74,33,98,87,216,77,613,348,265,599,1,0,11,13,75417,153,474.0,590.0
3002,"Wayne County, Utah",1386,104,82,89,66,74,148,66,49,55,49055,162,217,347,275,142,195,335,277,304,412,682,552,2689,1386,1303,2576,6,8,19,168,44245,423,1421.0,1596.0
3003,"Carbon County, Utah",10170,646,877,467,574,679,805,465,49,7,49007,1563,1869,2342,1599,1527,1861,2417,1810,3090,3730,4759,3409,20308,10170,10138,19348,91,10,482,2700,51158,2870,7952.0,8822.0
3004,"Morgan County, Utah",5983,559,571,384,414,532,623,343,49,29,49029,724,1075,1295,644,802,1090,1191,686,1526,2165,2486,1330,11664,5983,5681,11250,90,67,80,338,91341,1679,5192.0,6254.0
3005,"Cache County, Utah",62182,5510,5311,3113,5281,5253,5121,2919,49,5,49005,16704,10994,9827,5327,16740,10749,9908,6012,33444,21743,19735,11339,124165,62182,61983,112735,957,2550,3841,13316,59038,17638,46157.0,52792.0
3006,"Juab County, Utah",5705,499,690,351,468,519,569,320,49,23,49023,873,1088,1087,628,860,1129,1038,693,1733,2217,2125,1321,11301,5705,5596,10597,26,15,257,590,61463,1513,4177.0,5875.0
3007,"James City County, Virginia",36120,1923,2069,1320,1663,2052,2279,1492,51,95,51095,4552,5897,9628,8440,4345,6187,10822,9956,8897,12084,20450,18396,74916,36120,38796,60263,9846,1855,390,4316,87678,18351,43173.0,49314.0
3008,"Russell County, Virginia",13306,609,658,458,655,606,873,522,51,167,51167,1828,2291,4120,2542,1622,2302,4187,3068,3450,4593,8307,5610,27141,13306,13835,26522,274,0,1,317,39758,5184,12246.0,13368.0
3009,"Smyth County, Virginia",15161,763,780,552,711,814,795,535,51,173,51173,2221,2586,4322,2905,1979,2614,4495,3663,4200,5200,8817,6568,30767,15161,15606,29419,668,212,74,612,40932,6057,12890.0,14057.0
3010,"Charlottesville city, Virginia",22788,1126,928,557,1240,959,875,504,51,540,51540,7175,4913,4668,2242,7516,5111,5019,3084,14691,10024,9687,5326,47096,22788,24308,33247,8844,3327,186,2589,59471,11179,22472.0,24101.0
3011,"Campbell County, Virginia",26711,1396,1786,975,1433,1331,1671,1100,51,31,51031,4215,4891,7378,4747,4150,4747,8020,6062,8365,9638,15398,10809,55225,26711,28514,44982,7735,506,323,1394,49664,10409,27535.0,29739.0
3012,"Henrico County, Virginia",155240,10380,9856,6652,9735,10496,10114,6306,51,87,51087,24150,32265,40348,20095,24714,35208,46732,28990,48864,67473,87080,49085,327535,155240,172295,184326,97414,27171,6357,18496,70307,77995,163654.0,173610.0
3013,"King George County, Virginia",13213,809,1061,530,805,825,1051,593,51,99,51099,1974,2724,3551,1591,1710,2636,3632,1764,3684,5360,7183,3355,26229,13213,13016,20501,4288,351,106,1406,94274,5399,12059.0,14164.0
3014,"Lancaster County, Virginia",5034,212,230,106,218,300,125,173,51,103,51103,434,633,1385,1758,506,679,1568,2121,940,1312,2953,3879,10724,5034,5690,7299,3305,90,5,67,53711,2481,6645.0,7126.0
3015,"Lee County, Virginia",12530,583,559,421,504,587,620,388,51,105,51105,1744,2671,3516,2276,1342,1839,3440,2698,3086,4510,6956,4974,23948,12530,11418,22408,978,63,153,473,32888,4392,9399.0,9932.0
3016,"Mathews County, Virginia",4382,190,137,234,143,90,93,201,51,115,51115,509,680,1172,1255,423,524,1446,1486,932,1204,2618,2741,8788,4382,4406,7720,777,53,0,222,64237,2082,5311.0,5824.0
3017,"Middlesex County, Virginia",5202,146,332,182,282,240,254,91,51,119,51119,605,655,1521,1562,546,600,1705,1755,1151,1255,3226,3317,10675,5202,5473,8358,1485,9,326,133,57438,2200,6017.0,6764.0
3018,"Prince George County, Virginia",20593,1098,1047,668,1037,1002,1409,725,51,149,51149,3666,5369,5016,2416,2631,3441,4569,2707,6297,8810,9585,5123,38114,20593,17521,22455,12456,565,612,3096,71912,7406,16184.0,17182.0
3019,"Richmond County, Virginia",4857,74,204,53,180,297,330,84,51,159,51159,657,1191,1635,777,352,482,1198,1104,1009,1673,2833,1881,8884,4857,4027,5717,2370,30,268,633,49517,1566,3661.0,4091.0
3020,"Scott County, Virginia",11075,465,570,394,413,444,693,368,51,169,51169,1433,1935,3221,2380,1223,1704,3207,2775,2656,3639,6428,5155,21902,11075,10827,21446,127,68,19,302,39820,4238,10100.0,10845.0
3021,"Spotsylvania County, Virginia",65286,4216,4423,3154,4037,4309,4944,2950,51,177,51177,9964,12427,17785,8164,9570,12917,18721,10099,19534,25344,36506,18263,132833,65286,67547,95728,21451,3179,5803,12965,88628,25917,62562.0,75302.0
3022,"Appomattox County, Virginia",7599,432,433,277,462,474,437,349,51,11,51011,1077,1286,2140,1468,1035,1360,2276,1715,2112,2646,4416,3183,15707,7599,8108,12263,3105,12,31,260,58696,2828,8011.0,9268.0
3023,"Franklin County, Virginia",27578,1350,1629,1040,1262,1550,1378,1076,51,67,51067,3624,4177,8197,6049,3819,4127,8649,6748,7443,8304,16846,12797,56187,27578,28609,50056,4224,298,344,1566,56254,11680,26971.0,29459.0
3024,"King and Queen County, Virginia",3523,208,188,99,163,236,138,161,51,97,51097,503,544,1056,753,373,538,1035,875,876,1082,2091,1628,7042,3523,3519,4755,1867,0,56,226,63982,1624,3697.0,4104.0
3025,"Montgomery County, Virginia",50664,2181,1966,1253,2133,1957,2176,1255,51,121,51121,19447,8318,9842,5337,15296,7713,10310,6636,34743,16031,20152,11973,98140,50664,47476,83960,4449,6494,1113,3182,57977,21019,43031.0,44573.0
3026,"New Kent County, Virginia",10870,665,522,372,537,719,632,307,51,127,51127,1358,2163,3342,1727,1294,2117,3353,1857,2652,4280,6695,3584,21686,10870,10816,17653,2603,243,156,716,87904,4999,12242.0,12224.0
3027,"Cumberland County, Virginia",4847,305,341,195,155,111,390,205,51,49,51049,652,701,1421,987,642,932,1378,1164,1294,1633,2799,2151,9824,4847,4977,6235,2960,122,65,92,47469,1637,4906.0,5302.0
3028,"Dickenson County, Virginia",7472,374,412,261,353,316,468,272,51,51,51051,955,1432,2160,1447,907,1234,2021,1713,1862,2666,4181,3160,14756,7472,7284,14476,84,18,13,134,29932,3228,6440.0,7299.0
3029,"Halifax County, Virginia",16645,1016,909,710,859,957,928,594,51,83,51083,2310,2513,4656,3440,2147,2653,5112,4657,4457,5166,9768,8097,34552,16645,17907,21150,11959,276,104,714,42669,5400,17001.0,18192.0
3030,"Loudoun County, Virginia",195769,14266,16715,9323,14041,15885,16368,9283,51,107,51107,24455,46507,51903,15860,24080,49173,50780,19755,48535,95680,102683,35615,395134,195769,199365,256660,29906,73381,13282,53812,142299,114007,183097.0,224036.0
3031,"Prince William County, Virginia",230487,17641,17498,10588,16477,17276,17191,10322,51,153,51153,36283,51298,58544,19777,34214,51948,59276,24232,70497,103246,117820,44009,461423,230487,230936,261230,96927,38570,36461,108408,107132,98996,196538.0,219075.0
3032,"Southampton County, Virginia",9247,432,362,292,440,569,415,343,51,175,51175,1141,1459,3313,1638,1017,1362,2652,1835,2158,2821,5965,3473,17880,9247,8633,11151,5744,44,76,301,61348,2875,8878.0,9786.0
3033,"Highland County, Virginia",1062,47,26,6,38,41,66,26,51,91,51091,97,120,311,447,81,109,371,410,178,229,682,857,2204,1062,1142,2189,0,0,0,0,48587,557,1391.0,1531.0
3034,"Caroline County, Virginia",15102,1112,959,503,1041,1020,902,495,51,33,51033,2681,2654,4016,2215,2102,2878,4197,2644,4783,5532,8213,4859,30381,15102,15279,19820,8211,273,832,1466,65103,5255,14863.0,16097.0
3035,"Gloucester County, Virginia",18173,941,831,751,944,1253,807,636,51,73,51073,2475,3273,5603,3158,2502,3155,5989,3763,4977,6428,11592,6921,37222,18173,19049,32729,3341,282,27,1330,70537,7416,19619.0,22228.0
3036,"Patrick County, Virginia",8812,403,449,314,386,437,418,255,51,141,51141,987,1308,2787,2099,892,1255,2750,2543,1879,2563,5537,4642,17748,8812,8936,16354,1051,72,135,542,43073,3586,8525.0,9527.0
3037,"Powhatan County, Virginia",15324,610,698,622,681,570,793,464,51,145,51145,2208,3087,4776,2489,1472,2314,4582,2615,3680,5401,9358,5104,28815,15324,13491,25113,2895,73,124,631,89090,6665,16900.0,19730.0
3038,"Shenandoah County, Virginia",21301,1303,1347,886,1036,1329,1241,761,51,171,51171,2792,3542,6062,4092,2683,3623,6184,5066,5475,7165,12246,9158,43224,21301,21923,40391,815,420,413,3120,57252,9242,20513.0,23522.0
3039,"Fauquier County, Virginia",34507,1987,2263,1647,2006,1912,2458,1540,51,61,51061,4623,6084,10230,5169,4531,6195,10464,6115,9154,12279,20694,11284,69728,34507,35221,60352,5170,1169,504,5791,100783,16002,37467.0,43260.0
3040,"Staunton city, Virginia",11171,727,617,349,723,612,474,409,51,790,51790,1465,2279,2880,2135,2236,2361,3455,2991,3701,4640,6335,5126,24432,11171,13261,20376,2754,337,73,760,52611,5174,11255.0,12781.0
3041,"Fluvanna County, Virginia",12217,662,793,508,525,779,723,521,51,65,51065,1449,2123,3461,2367,1922,3009,4103,2795,3371,5132,7564,5162,26594,12217,14377,21348,3787,318,212,937,76873,5914,13597.0,15620.0
3042,"Webster County, Mississippi",4753,258,349,210,311,306,313,204,28,155,28155,673,801,1325,771,668,872,1361,980,1341,1673,2686,1751,9768,4753,5015,7697,1995,34,10,68,45730,2015,5069.0,5347.0
3043,"Alcorn County, Mississippi",18218,1127,1245,858,1051,1278,961,821,28,3,28003,2675,3531,4577,2892,2484,3567,4847,3863,5159,7098,9424,6755,37090,18218,18872,31319,4492,110,439,1179,42086,6135,14783.0,15639.0
3044,"Clay County, Mississippi",9144,504,596,409,614,584,720,412,28,25,28025,1480,1628,2340,1498,1571,1814,2772,2009,3051,3442,5112,3507,19640,9144,10496,7622,11784,57,0,14,31833,2670,10003.0,10054.0
3045,"Covington County, Mississippi",9253,631,749,423,661,656,577,347,28,31,28031,1496,1542,2333,1417,1461,1877,2342,1804,2957,3419,4675,3221,18978,9253,9725,11886,6946,0,2,452,38178,2872,8811.0,9294.0
3046,"Humphreys County, Mississippi",4011,256,362,234,258,407,286,138,28,53,28053,611,608,1044,588,571,725,1211,782,1182,1333,2255,1370,8389,4011,4378,1743,6375,7,236,278,28962,770,4253.0,4164.0
3047,"Dauphin County, Pennsylvania",133579,8841,8160,5444,8362,7941,8991,5157,42,43,42043,20976,24630,36639,19716,21028,26022,38719,25833,42004,50652,75358,45549,275632,133579,142053,193282,53826,12073,7074,25457,60715,58015,130872.0,144861.0
3048,"Franklin County, Pennsylvania",75710,4701,4610,3122,4605,4192,5091,3018,42,55,42055,10589,13625,20654,13129,10503,13656,20828,16544,21092,27281,41482,29673,154147,75710,78437,142470,5774,1296,977,8694,63379,34971,69731.0,79904.0
3049,"Union County, Pennsylvania",24755,1074,1062,833,1011,999,1128,766,42,119,42119,5021,5319,6764,3491,3941,3053,4953,4505,8962,8372,11717,7996,45111,24755,20356,39190,2898,754,1022,2654,59399,9298,17468.0,20078.0
3050,"Wayne County, Pennsylvania",27286,1148,1180,853,1001,1029,1226,867,42,127,42127,3671,4986,8351,5795,2750,3585,7395,6283,6421,8571,15746,12078,51422,27286,24136,48194,1639,304,179,2297,56096,12528,24018.0,27915.0
3051,"Bedford County, Pennsylvania",23972,1225,1377,941,1108,1300,1349,874,42,9,42009,3189,3755,7269,4891,2914,3760,7200,5860,6103,7515,14469,10751,48337,23972,24365,47175,310,191,105,589,50509,12413,23637.0,27018.0
3052,"Monroe County, Pennsylvania",83112,3813,4604,3593,3753,4175,5011,3484,42,89,42089,14437,13007,25461,13295,13639,13683,26196,14979,28076,26690,51657,28274,168032,83112,84920,128246,24704,4096,5088,26701,63934,35409,69752.0,80477.0
3053,"Huntingdon County, Pennsylvania",24111,1006,1135,799,1023,1043,1281,731,42,61,42061,4055,4627,6797,4438,3127,3323,5869,4861,7182,7950,12666,9299,45369,24111,21258,41519,2548,269,200,896,51678,11141,19706.0,22844.0
3054,"Washington County, Pennsylvania",101740,5325,6219,3684,5133,6070,5129,3499,42,125,42125,15053,17645,29886,18417,14172,17427,30751,23291,29225,35072,60637,41708,207212,101740,105472,193929,6498,1971,421,3540,63543,50058,101450.0,117658.0
3055,"Philadelphia County, Pennsylvania",747479,54511,46756,26555,52052,46508,45192,25869,42,101,42101,156150,159991,170560,84838,164794,173150,196595,127436,320944,333141,367155,212274,1579075,747479,831596,642060,665333,114315,102480,231858,45927,291135,707631.0,688083.0
3056,"York County, Pennsylvania",220122,13108,14092,8978,12460,13090,13968,8400,42,133,42133,32764,40319,62101,34099,31239,40807,63554,41925,64003,81126,125655,76024,445565,220122,225443,393960,26395,6831,6188,33221,66457,98985,205986.0,232733.0
3057,"Indiana County, Pennsylvania",42572,2115,2101,1439,1876,1996,2201,1329,42,63,42063,9602,6556,11233,7277,9105,6210,11061,8682,18707,12766,22294,15959,85032,42572,42460,80516,1955,840,259,1101,49320,19391,37770.0,40835.0
3058,"Cumberland County, Pennsylvania",123397,6815,7092,4533,6542,7223,6712,4202,42,41,42041,20614,24480,32700,19725,19683,22575,33489,25505,40297,47055,66189,45230,249328,123397,125931,218742,9884,10631,2962,9815,71269,61038,121617.0,139711.0
3059,"Allegheny County, Pennsylvania",590342,32710,31374,20265,31460,30074,31479,19375,42,3,42003,102685,117561,157826,94998,101998,115221,170669,131126,204683,232782,328495,226124,1221744,590342,631402,976172,157060,45389,6088,25777,61043,299528,650114.0,693307.0
3060,"Westmoreland County, Pennsylvania",172407,8123,8967,6345,7887,9019,9091,5889,42,129,42129,23638,28554,52709,34245,21916,28134,54431,43816,45554,56688,107140,78061,352590,172407,180183,333734,8330,3257,882,4187,60471,85375,182051.0,201805.0
3061,"Forest County, Pennsylvania",5318,83,64,214,71,66,103,69,42,53,42053,1304,1577,1132,829,38,111,763,774,1342,1688,1895,1603,7313,5318,1995,5095,1893,8,115,405,39717,1731,2401.0,2621.0
3062,"Blair County, Pennsylvania",60259,3423,3379,2312,3073,3395,3503,2119,42,13,42013,9158,10655,16636,10768,8598,10370,17612,14228,17756,21025,34248,24996,123157,60259,62898,117570,2053,756,426,1562,49181,29169,54909.0,62898.0
3063,"Lawrence County, Pennsylvania",41947,2310,2262,1623,2207,2278,2509,1563,42,73,42073,6146,6888,12194,7987,5784,7000,12766,10673,11930,13888,24960,18660,86727,41947,44780,80717,3153,403,276,1261,50204,19927,40753.0,45217.0
3064,"Bradford County, Pennsylvania",30071,1808,1818,1117,1834,1869,1881,1115,42,15,42015,3965,4763,8668,5943,3863,4832,8770,6728,7828,9595,17438,12671,60963,30071,30892,58934,337,437,317,901,52358,14967,25708.0,30056.0
3065,"Cambria County, Pennsylvania",65461,3446,3614,2481,3163,3360,3635,2308,42,21,42021,10006,10572,18962,12691,9210,10429,18894,16549,19216,21001,37856,29240,133009,65461,67548,124399,4618,579,488,2174,46659,31437,63072.0,70418.0
3066,"Chester County, Pennsylvania",255927,14667,16569,11202,14325,15915,17465,10642,42,29,42029,38731,47105,72286,37062,37804,46942,74988,45552,76535,94047,147274,82614,519560,255927,263633,440431,30438,28448,7577,38522,100214,137585,268800.0,310650.0
3067,"Berks County, Pennsylvania",205638,12383,13668,8681,11818,12769,13017,8332,42,11,42011,34063,36159,55939,31375,32755,36877,57466,39353,66818,73036,113405,70728,418025,205638,212387,344474,22697,5850,23405,87914,63728,88431,183065.0,198803.0
3068,"Mifflin County, Pennsylvania",22589,1452,1224,923,1407,1620,1255,843,42,87,42087,3132,3615,6285,4292,2959,3662,6446,5495,6091,7277,12731,9787,46276,22589,23687,44839,248,153,232,724,50219,9888,18601.0,21317.0
3069,"Mercer County, Missouri",1817,124,116,91,116,138,94,82,29,129,29129,225,267,498,369,225,274,497,401,450,541,995,770,3644,1817,1827,3548,20,17,23,84,47298,921,1745.0,1779.0
3070,"Wright County, Missouri",8910,714,651,411,580,608,685,406,29,229,29229,1196,1411,2341,1607,1057,1457,2570,1930,2253,2868,4911,3537,18203,8910,9293,17593,97,45,94,344,34776,3746,8119.0,8741.0
3071,"Clay County, Missouri",118973,8204,8727,5084,7597,8183,8071,4885,29,47,29047,18490,25355,30177,14748,18414,25802,31802,18789,36904,51157,61979,33537,242516,118973,123543,206471,14884,5332,4402,16479,70510,52463,110176.0,126618.0
3072,"Dent County, Missouri",7771,468,604,369,398,572,410,302,29,65,29065,920,1272,2186,1537,905,1184,2201,1802,1825,2456,4387,3339,15545,7771,7774,14805,84,39,44,274,42100,3178,6791.0,7142.0
3073,"Saline County, Missouri",11569,722,761,503,717,785,701,374,29,195,29195,2125,2152,2758,1800,1799,1931,2756,2344,3924,4083,5514,4144,22976,11569,11407,19851,1150,187,812,2341,44720,4513,9274.0,9528.0
3074,"Worth County, Missouri",976,50,56,35,62,67,36,47,29,227,29227,111,152,293,222,134,146,281,278,245,298,574,500,2027,976,1051,1982,11,3,0,31,53580,466,1046.0,1107.0
3075,"Grundy County, Missouri",4902,376,279,166,339,311,289,236,29,79,29079,840,748,1225,936,736,704,1239,1236,1576,1452,2464,2172,9992,4902,5090,9591,28,64,28,244,45594,2151,4310.0,4437.0
3076,"Morgan County, Missouri",9959,610,749,350,710,500,672,497,29,141,29141,1180,1477,2773,2275,1195,1482,2795,2461,2375,2959,5568,4736,20271,9959,10312,19448,178,182,16,458,39003,3827,8821.0,9484.0
3077,"Reynolds County, Missouri",3290,139,227,182,125,135,174,114,29,179,29179,403,549,941,696,309,528,886,729,712,1077,1827,1425,6290,3290,3000,5939,128,19,4,50,40324,1425,3038.0,3298.0
3078,"St. Louis County, Missouri",472970,29755,30496,20024,28795,28680,31254,19302,29,189,29189,74471,86629,125923,73614,75685,94804,142893,102536,150156,181433,268816,176150,996919,472970,523949,677308,240884,42911,9348,28834,67420,223717,514858.0,528107.0
3079,"Stone County, Missouri",15430,626,581,544,607,562,926,532,29,209,29209,1671,1984,4517,4610,1477,2200,4900,4981,3148,4184,9417,9591,31615,15430,16185,30437,64,74,264,729,49656,6044,16567.0,18378.0
3080,"Barry County, Missouri",17731,1095,1238,726,958,997,1134,659,29,9,29009,2335,2760,5005,3325,2131,3020,5042,3858,4466,5780,10047,7183,35530,17731,17799,32723,80,497,813,3321,44403,6708,14605.0,15616.0
3081,"Boone County, Missouri",86335,5375,5390,3031,5031,4332,5328,2661,29,19,29019,23745,16484,18023,9376,25818,16568,19874,11704,49563,33052,37897,21080,177651,86335,91316,144228,15952,7880,1681,6086,55328,38203,83868.0,91200.0
3082,"Cole County, Missouri",38674,2262,2294,1516,2330,2409,2483,1442,29,51,29051,6248,8217,10257,5372,5621,6816,10014,6934,11869,15033,20271,12306,76723,38674,38049,64416,8985,1194,184,2176,60066,17393,37374.0,39486.0
3083,"Crawford County, Missouri",11920,688,776,520,683,742,839,498,29,55,29055,1614,2022,3342,2145,1547,2098,3339,2488,3161,4120,6681,4633,24154,11920,12234,23350,90,51,139,485,44438,4498,9696.0,10973.0
3084,"Iron County, Missouri",5004,280,262,209,252,222,338,193,29,93,29093,609,821,1464,1002,583,867,1477,1228,1192,1688,2941,2230,10164,5004,5160,9713,113,27,0,181,37435,2063,4269.0,4592.0
3085,"Livingston County, Missouri",6740,510,481,300,397,432,550,236,29,117,29117,890,1160,1658,1329,1235,1863,1997,1676,2125,3023,3655,3005,15126,6740,8386,14146,388,94,73,278,46992,3103,6421.0,6755.0
3086,"Moniteau County, Missouri",8517,526,542,311,532,516,598,346,29,135,29135,1353,1911,2137,1156,947,1336,1909,1345,2300,3247,4046,2501,16046,8517,7529,15403,438,9,31,782,58010,3371,6830.0,7150.0
3087,"Pemiscot County, Missouri",7817,592,597,408,646,528,598,329,29,155,29155,1151,1222,2053,1157,1329,1552,2264,1600,2480,2774,4317,2757,16663,7817,8846,11587,4587,0,189,435,33859,2777,6027.0,5727.0
3088,"Pettis County, Missouri",21063,1544,1508,905,1369,1193,1545,829,29,159,29159,3206,3860,5378,3031,3289,3738,5417,3912,6495,7598,10795,6943,42355,21063,21292,38705,1483,279,907,3670,46157,7670,18111.0,19069.0
3089,"Shannon County, Missouri",4016,243,255,142,215,336,177,169,29,203,29203,533,594,1190,793,540,601,1230,933,1073,1195,2420,1726,8217,4016,4201,7862,14,0,0,154,34265,1966,3904.0,3908.0
3090,"Randolph County, Missouri",12987,774,800,497,697,925,558,449,29,175,29175,2198,2739,3447,1781,1806,1977,3175,2304,4004,4716,6622,4085,24878,12987,11891,22388,1463,158,108,523,47740,4940,10309.0,10742.0
3091,"Dunklin County, Missouri",14368,1044,1050,739,1023,929,1169,571,29,69,29069,2022,2371,3738,2244,2091,2625,4138,3113,4113,4996,7876,5357,30027,14368,15659,25396,3068,177,694,1991,36380,5221,10578.0,10419.0
3092,"Franklin County, Missouri",51467,3172,3348,2266,3054,3153,3076,2014,29,71,29071,7463,8989,14680,7841,6978,8839,15036,9574,14441,17828,29716,17415,103191,51467,51724,99053,745,511,606,1799,57214,20705,50113.0,53750.0
3093,"Howard County, Missouri",5096,310,373,210,281,303,278,164,29,89,29089,951,760,1355,840,838,802,1279,1017,1789,1562,2634,1857,10058,5096,4962,9214,598,36,37,158,52700,2196,4868.0,5089.0
3094,"Jackson County, Missouri",336640,23574,23085,13569,22774,22657,22736,13134,29,95,29095,56405,67787,85279,43426,57874,70695,91214,58492,114279,138482,176493,101918,696216,336640,359576,466132,162382,12821,27412,62514,55134,134681,173275.0,330771.0
3095,"Miller County, Missouri",12466,775,822,515,882,882,707,511,29,131,29131,1698,2154,3333,2272,1690,2131,3461,2471,3388,4285,6794,4743,25201,12466,12735,24372,63,121,17,489,47171,5703,11416.0,12379.0
3096,"Putnam County, Missouri",2403,174,161,95,144,154,124,94,29,171,29171,281,345,636,545,285,334,643,600,566,679,1279,1145,4781,2403,2378,4611,5,6,0,23,42849,1156,2346.0,2361.0
3097,"Taney County, Missouri",26630,1583,1771,1012,1525,1466,1715,1069,29,213,29213,4254,4332,6776,5335,4431,4576,7308,6394,8685,8908,14084,11729,55114,26630,28484,50517,839,546,1436,3260,46031,9907,23515.0,26240.0
3098,"Buchanan County, Missouri",44631,2997,2642,1615,2669,2652,2881,1647,29,21,29021,7592,9428,11400,6013,6903,7754,11322,8001,14495,17182,22722,14014,88460,44631,43829,77199,4588,962,1430,5776,51916,17738,35659.0,36713.0
3099,"Caldwell County, Missouri",4583,282,287,212,252,259,315,191,29,25,29025,609,748,1261,827,536,768,1213,922,1145,1516,2474,1749,9039,4583,4456,8653,52,37,13,147,49839,2011,4312.0,4696.0
3100,"Radford city, Virginia",8388,303,268,187,249,330,150,125,51,750,51750,4072,986,1635,679,4687,1158,1751,853,8759,2144,3386,1532,17691,8388,9303,15001,1743,275,91,513,36297,2679,6085.0,6289.0
3101,"Winchester city, Virginia",13694,1055,940,524,817,942,779,514,51,840,51840,2450,2507,3465,1926,2589,2360,3685,2517,5039,4867,7150,4443,27897,13694,14203,22878,2808,624,330,4958,58818,5381,10667.0,11812.0
3102,"Accomack County, Virginia",15934,974,966,697,908,977,859,469,51,1,51001,1982,2588,4306,3357,1930,2617,4912,4067,3912,5205,9218,7424,32673,15934,16739,22282,9331,265,279,2929,46073,5663,15818.0,16959.0
3103,"Craig County, Virginia",2378,159,187,82,144,131,131,89,51,45,51045,259,437,755,467,356,484,776,621,615,921,1531,1088,5110,2378,2732,5040,6,0,1,2,55708,1282,2794.0,3163.0
3104,"Floyd County, Virginia",7896,431,446,336,312,310,500,327,51,63,51063,868,1402,2390,1617,908,1218,2313,1920,1776,2620,4703,3537,15704,7896,7808,14967,240,28,118,462,51521,3884,8051.0,9329.0
3105,"Giles County, Virginia",8222,420,500,328,448,581,384,317,51,71,51071,1065,1442,2359,1619,1088,1372,2409,1951,2153,2814,4768,3570,16772,8222,8550,16206,361,22,1,293,54520,3618,8212.0,9157.0
3106,"Grayson County, Virginia",8070,312,440,264,380,234,424,227,51,77,51077,1137,1399,2402,1740,855,1139,2373,2040,1992,2538,4775,3780,15742,8070,7672,14554,893,55,74,543,36544,3308,7285.0,8120.0
3107,"Nottoway County, Virginia",8471,471,508,316,349,379,462,183,51,135,51135,1510,1747,2302,1292,850,1277,1829,1633,2360,3024,4131,2925,15433,8471,6962,8815,6276,46,158,681,45535,2449,6744.0,7080.0
3108,"Rappahannock County, Virginia",3743,192,119,174,160,162,188,45,51,157,51157,512,507,1043,948,444,526,1151,959,956,1033,2194,1907,7378,3743,3635,6661,335,38,84,287,74284,1823,4483.0,4967.0
3109,"Charles City County, Virginia",3430,166,108,125,118,140,157,89,51,36,51036,419,489,1182,758,401,506,1253,920,820,995,2435,1678,7014,3430,3584,3066,3187,67,19,131,57198,1037,4107.0,4439.0
3110,"Culpeper County, Virginia",25557,1665,1648,1119,1623,1813,1821,1030,51,47,51047,3615,5047,6907,3634,3286,4886,6857,4228,6901,9933,13764,7862,51101,25557,25544,38697,7404,855,2161,5476,77935,9293,22218.0,27117.0
3111,"Dinwiddie County, Virginia",13993,844,793,503,663,762,834,514,51,53,51053,2086,2552,4112,2180,2077,2528,4410,2704,4163,5080,8522,4884,28485,13993,14492,18401,9064,252,300,991,60346,5135,13575.0,15063.0
3112,"Greene County, Virginia",9537,601,750,558,508,677,765,328,51,79,51079,1201,1872,2601,1443,1177,1947,2791,1789,2378,3819,5392,3232,19519,9537,9982,16926,1052,332,397,1142,67398,4005,9608.0,11144.0
3113,"Hanover County, Virginia",51736,2783,3239,2312,2473,2918,3602,2265,51,85,51085,7432,8869,15216,8106,6906,9233,16398,10006,14338,18102,31614,18112,105537,51736,53801,90541,9874,1637,761,3144,89390,24412,62753.0,70728.0
3114,"Lunenburg County, Virginia",6302,244,204,121,318,263,309,354,51,111,51111,932,1293,1894,1194,762,888,1643,1443,1694,2181,3537,2637,12282,6302,5980,7764,3830,340,16,609,44303,1981,5586.0,6038.0
3115,"Orange County, Virginia",17712,1124,1103,729,911,1234,1036,636,51,137,51137,2437,3011,4962,3170,2257,3322,4965,3937,4694,6333,9927,7107,36010,17712,18298,29344,4622,341,373,1801,71548,7096,17270.0,20688.0
3116,"Emporia city, Virginia",2455,15,207,218,257,158,339,64,51,595,51595,376,389,642,302,489,521,545,614,865,910,1187,916,5442,2455,2987,1525,3440,14,4,370,27063,540,2367.0,2379.0
3117,"Wythe County, Virginia",14090,696,787,577,661,868,796,526,51,197,51197,1756,2496,4251,2692,1727,2587,4307,3282,3483,5083,8558,5974,28844,14090,14754,27375,837,129,40,361,49364,6338,13343.0,15046.0
3118,"Chesapeake city, Virginia",117267,7672,8465,5362,7472,8258,7833,5055,51,550,51550,19379,24408,30447,13473,18180,25272,33033,17612,37559,49680,63480,31085,239982,117267,122715,146540,72084,7571,3646,14824,78640,49005,112705.0,125009.0
3119,"Harrisonburg city, Virginia",25548,1433,1255,604,1295,1313,1067,594,51,660,51660,9815,4888,4369,2036,11779,4546,4389,2742,21594,9434,8758,4778,53273,25548,27725,42838,3946,2073,786,10518,46679,8630,17993.0,16851.0
3120,"Albemarle County, Virginia",51363,2925,3221,1867,2858,2991,2941,1951,51,3,51003,9517,9613,12743,8508,10246,9631,14592,10832,19763,19244,27335,19340,107405,51363,56042,87831,10245,5590,822,6200,79880,27942,56726.0,64209.0
3121,"Bedford County, Virginia",38462,1899,2460,1538,1810,2072,2442,1542,51,19,51019,5037,5983,11867,7638,4766,6201,12376,8705,9803,12184,24243,16343,78376,38462,39914,70090,5384,943,283,1720,64199,17122,42525.0,48041.0
3122,"Buckingham County, Virginia",9363,372,374,219,383,358,501,349,51,29,51029,1466,2081,2732,1544,938,1210,2217,1740,2404,3291,4949,3284,17059,9363,7696,10506,5885,28,266,411,49025,3119,7295.0,8108.0
3123,"Wise County, Virginia",20173,959,1091,705,899,1135,945,658,51,195,51195,3722,4023,5498,3105,2621,3139,5215,3701,6343,7162,10713,6806,38486,20173,18313,35448,2112,156,61,477,38888,6088,15163.0,16505.0
3124,"Covington city, Virginia",2680,142,188,60,190,135,174,99,51,580,51580,497,457,716,461,389,517,744,670,886,974,1460,1131,5598,2680,2918,4596,732,65,0,133,40655,1211,2382.0,2594.0
3125,"Portsmouth city, Virginia",45704,3704,3167,1637,3405,3155,2839,1600,51,740,51740,9077,9030,10677,5642,8292,9658,12312,8132,17369,18688,22989,13774,95097,45704,49393,37831,50274,1328,1554,4242,52175,15254,43265.0,44576.0
3126,"Virginia Beach city, Virginia",221324,14553,13519,8491,14023,13955,12964,7981,51,810,51810,42934,47555,52983,26458,38412,47044,59152,35346,81346,94599,112135,61804,450201,221324,228877,298347,85609,30130,9285,36785,76610,93276,203262.0,253477.0
3127,"Alleghany County, Virginia",7367,358,426,268,315,430,296,325,51,5,51005,1026,1066,2191,1586,912,1162,2329,2021,1938,2228,4520,3607,15157,7367,7790,14012,881,16,76,225,47673,3085,7325.0,8191.0
3128,"Galax city, Virginia",3090,202,207,58,130,195,264,86,51,640,51640,213,614,900,624,450,573,895,834,663,1187,1795,1458,6517,3090,3427,5842,491,42,109,945,33575,946,2376.0,2629.0
3129,"Westmoreland County, Virginia",8793,568,510,247,339,692,266,204,51,193,51193,1120,1351,2463,2015,1100,1301,2666,2390,2220,2652,5129,4405,17751,8793,8958,12054,4598,129,439,1147,53853,2970,8574.0,9853.0
3130,"Northumberland County, Virginia",5931,219,438,54,142,283,314,158,51,133,51133,488,563,1786,2179,599,670,1799,2294,1087,1233,3585,4473,12190,5931,6259,8605,3331,16,0,106,62632,2643,7398.0,7772.0
3131,"Pulaski County, Virginia",17122,819,624,600,787,905,769,535,51,155,51155,2516,2920,5123,3474,2065,2655,5127,4217,4581,5575,10250,7691,34182,17122,17060,31474,1485,255,165,604,53866,6804,15167.0,17376.0
3132,"Warren County, Virginia",19657,1062,1203,763,1263,1419,942,773,51,187,51187,3069,3413,5961,2868,2922,3320,5894,3302,5991,6733,11855,6170,39492,19657,19835,35138,1702,444,756,1811,69116,8013,17960.0,20959.0
3133,"Danville city, Virginia",18883,1172,1455,868,1247,1273,1240,577,51,590,51590,3168,3122,4764,3195,3218,3517,5968,5147,6386,6639,10732,8342,41070,18883,22187,18687,20283,483,227,1773,37203,5265,18952.0,19204.0
3134,"Fredericksburg city, Virginia",12997,1005,848,333,992,696,906,499,51,630,51630,3371,2832,2638,1244,4728,2789,3175,1840,8099,5621,5813,3084,28622,12997,15625,17839,6322,764,1552,3056,65641,5047,11264.0,12794.0
3135,"Amherst County, Virginia",15290,871,683,525,853,824,946,478,51,9,51009,2240,2564,4489,2861,2263,2665,4785,3671,4503,5229,9274,6532,31775,15290,16485,24381,5709,162,286,766,52888,6190,15396.0,16985.0
3136,"Bath County, Virginia",2201,69,138,83,135,53,21,68,51,17,51017,301,244,735,474,440,319,579,491,741,563,1314,965,4307,2201,2106,3933,130,15,39,159,49738,957,2253.0,2513.0
3137,"Hopewell city, Virginia",10499,845,1064,481,822,813,737,403,51,670,51670,1696,1822,2657,1335,1877,2200,2956,2149,3573,4022,5613,3484,22456,10499,11957,11435,9778,307,371,1781,39030,3098,9008.0,9630.0
3138,"Newport News city, Virginia",86860,6771,5827,3182,6346,6227,4692,3092,51,700,51700,19332,17434,19470,9278,18457,18307,22226,13466,37789,35741,41696,22744,179673,86860,92813,86132,73785,5773,3880,16142,53215,29322,75715.0,77859.0
3139,"Frederick County, Virginia",43042,2666,2659,1846,2482,2648,2844,1702,51,69,51069,6152,7913,11962,6750,5747,8067,12119,7764,11899,15980,24081,14514,86415,43042,43373,78403,3405,1174,689,7428,78002,19044,40440.0,46918.0
3140,"Lynchburg city, Virginia",37729,2527,2017,1188,2358,1854,2131,1282,51,680,51680,12649,5546,7062,4589,14167,6039,8230,6779,26816,11585,15292,11368,80569,37729,42840,52348,23069,1973,920,3361,46409,12427,35671.0,35866.0
3141,"York County, Virginia",33376,1931,2183,1478,1848,2103,2596,1599,51,199,51199,5255,6445,8739,4838,4432,6759,9443,5826,9687,13204,18182,10664,67982,33376,34606,50604,9034,3833,969,4372,92069,15712,34118.0,38165.0
3142,"Martinsville city, Virginia",5707,394,361,230,652,382,418,213,51,690,51690,856,924,1562,933,990,1065,1961,1464,1846,1989,3523,2397,12852,5707,7145,6175,5834,131,137,727,34371,1803,5907.0,6004.0
3143,"Nelson County, Virginia",7243,387,449,239,276,439,369,181,51,125,51125,876,986,2126,1766,702,1129,2405,2087,1578,2115,4531,3853,14831,7243,7588,12539,1921,33,171,618,64313,3565,8318.0,9335.0
3144,"Pittsylvania County, Virginia",30113,1251,1580,1201,1309,1759,1624,1190,51,143,51143,3949,4998,9308,6037,3566,4817,9543,7335,7515,9815,18851,13372,61256,30113,31143,46202,12307,275,593,1612,47690,10510,31598.0,34041.0
3145,"Buena Vista city, Virginia",2776,93,183,45,237,232,317,97,51,530,51530,687,375,780,473,809,403,890,723,1496,778,1670,1196,6484,2776,3708,5784,472,123,42,117,32455,986,2407.0,2815.0
3146,"Falls Church city, Virginia",6868,381,601,366,364,443,547,295,51,610,51610,837,1537,1843,776,971,1372,2228,1040,1808,2909,4071,1816,14128,6868,7260,11213,692,1396,284,1507,127610,4369,7757.0,8750.0
3147,"Petersburg city, Virginia",14294,1145,899,472,1138,1029,642,506,51,730,51730,2713,2475,3748,1971,3126,2820,4537,3270,5839,5295,8285,5241,31362,14294,17068,5473,24044,292,732,1536,38679,3947,13786.0,13973.0
3148,"Poquoson city, Virginia",6023,292,347,391,262,347,458,181,51,735,51735,826,1000,1686,1091,735,1052,1749,1283,1561,2052,3435,2374,12090,6023,6067,11348,136,299,45,338,97118,2998,7177.0,7819.0
3149,"Fairfax city, Virginia",11444,816,725,416,879,697,747,387,51,600,51600,1989,2409,3068,1439,1751,2418,3149,2059,3740,4827,6217,3498,23531,11444,12087,15955,1157,4040,1166,4043,116979,6836,12030.0,13303.0
3150,"Waynesboro city, Virginia",10836,861,805,442,549,854,596,224,51,820,51820,1614,2105,2568,1614,1904,2074,2813,2290,3518,4179,5381,3904,22140,10836,11304,18025,3149,239,73,1788,45011,4393,9204.0,10638.0
3151,"Roanoke city, Virginia",47256,3328,3197,1561,3455,3125,2654,1562,51,770,51770,7521,9841,12577,6412,8215,9995,13391,9576,15736,19836,25968,15988,99229,47256,51973,61909,28753,2956,1048,6223,44230,17591,39466.0,42033.0
3152,"Suffolk city, Virginia",43698,3189,3277,1880,2770,2852,3205,1752,51,800,51800,6584,8537,11698,5555,6556,9212,12839,7209,13140,17749,24537,12764,90093,43698,46395,46357,37648,1770,704,3937,74884,16662,43240.0,49213.0
3153,"Norfolk city, Virginia",127723,8188,6675,3332,7890,6431,6186,3207,51,710,51710,42095,25730,24251,11157,28761,22195,26795,15413,70856,47925,51046,26570,244601,127723,116878,114890,100649,9029,7431,19672,51590,38372,83388.0,83041.0
3154,"Amelia County, Virginia",6580,441,537,313,322,425,244,182,51,7,51007,853,1015,1990,1119,812,1017,2007,1364,1665,2032,3997,2483,12953,6580,6373,9824,2745,0,0,390,57946,2586,7040.0,7837.0
3155,"Chesterfield County, Virginia",165585,10796,11780,7844,9830,10905,11783,7260,51,41,51041,24612,32126,44493,22059,25601,35231,49871,27485,50213,67357,94364,49544,343551,165585,177966,230914,79347,11858,9484,30350,82599,77434,176461.0,212576.0
3156,"Fairfax County, Virginia",568173,37984,38599,23266,36020,36420,37072,22305,51,59,51059,86547,122425,152064,68739,82575,123349,158764,81184,169122,245774,310828,149923,1145862,568173,577689,701055,112371,219697,55913,187160,124831,338570,551183.0,578931.0
3157,"Okanogan County, Washington",21253,1351,1496,801,1234,1307,1300,748,53,47,53047,2785,3540,5484,4418,2521,3381,5679,4419,5306,6921,11163,8837,41842,21253,20589,30320,186,358,4553,8413,47240,7169,17091.0,16985.0
3158,"Kittitas County, Washington",23167,1131,1235,676,1008,1133,1011,605,53,37,53037,6636,3565,5362,3460,6453,3421,5339,3760,13089,6986,10701,7220,45897,23167,22730,40611,443,729,1726,4045,56004,8370,18955.0,25579.0
3159,"Cass County, Missouri",50618,3156,3944,2408,2962,3679,3380,2178,29,37,29037,7137,9502,13512,7452,6845,9835,14450,9650,13982,19337,27962,17102,103597,50618,52979,94521,4238,796,695,4541,69433,22109,50990.0,57524.0
3160,"Clinton County, Missouri",10149,554,674,498,542,684,640,539,29,49,29049,1296,1721,2897,1704,1214,1940,2913,1879,2510,3661,5810,3583,20500,10149,10351,19612,310,136,18,439,62701,4551,10208.0,10894.0
3161,"Dallas County, Missouri",8109,486,553,335,562,615,446,311,29,59,29059,1027,1294,2249,1549,1093,1311,2312,1858,2120,2605,4561,3407,16617,8109,8508,15991,13,91,33,348,43542,3489,7453.0,8122.0
3162,"Hickory County, Missouri",4623,174,195,158,231,206,234,147,29,85,29085,422,520,1320,1579,421,591,1378,1573,843,1111,2698,3152,9404,4623,4781,9044,3,25,33,164,34182,2151,4724.0,5080.0
3163,"Lincoln County, Missouri",28056,1801,2311,1395,1963,1985,1845,1237,29,113,29113,4276,5282,7687,3422,4196,5439,7679,4077,8472,10721,15366,7499,56477,28056,28421,53593,1088,158,242,1401,64196,12617,24962.0,28814.0
3164,"Monroe County, Missouri",4376,235,250,218,227,196,277,152,29,137,29137,484,707,1259,929,511,635,1217,1038,995,1342,2476,1967,8629,4376,4253,8156,293,41,0,145,43966,2033,4156.0,4469.0
3165,"Newton County, Missouri",28812,1903,1683,1219,1702,1650,2184,1220,29,145,29145,4416,4976,7518,4681,4045,4977,7949,5641,8461,9953,15467,10322,58180,28812,29368,52559,549,831,313,3093,50813,10915,26606.0,28396.0
3166,"Pike County, Missouri",10117,593,573,357,484,679,445,344,29,163,29163,1786,2081,2707,1453,1086,1441,2171,1688,2872,3522,4878,3141,18455,10117,8338,16421,1338,64,151,415,46385,4451,7382.0,7686.0
3167,"St. Charles County, Missouri",193719,11898,13328,8325,11619,12566,13401,8062,29,183,29183,29449,39744,51610,25613,28273,39929,54300,32421,57722,79673,105910,58034,394290,193719,200571,353297,17468,10183,2416,12981,84978,87093,201005.0,222175.0
3168,"Cape Girardeau County, Missouri",37976,2308,2733,1361,2213,2468,2257,1392,29,31,29031,7933,6749,9313,5501,8363,6876,9734,7212,16296,13625,19047,12713,78491,37976,40515,68877,5788,1348,293,1827,53732,16771,37038.0,40252.0
3169,"Coffee County, Tennessee",27141,1965,1955,1160,1540,1861,1799,1127,47,31,47031,3998,4782,7379,4078,3958,5089,7294,5400,7956,9871,14673,9478,55209,27141,28068,49924,2163,596,1332,2382,50351,10739,19971.0,24313.0
3170,"Fayette County, Tennessee",19813,1012,1059,820,1013,1070,1063,631,47,47,47047,2518,3390,5869,3945,2503,3413,6272,4386,5021,6803,12141,8331,40164,19813,20351,27926,11000,269,253,1086,60711,6795,19394.0,22928.0
3171,"Hancock County, Tennessee",3305,148,208,157,191,238,128,99,47,67,47067,424,573,935,640,405,551,958,712,829,1124,1893,1352,6587,3305,3282,6476,33,39,6,105,30136,1383,2231.0,2744.0
3172,"Hawkins County, Tennessee",27657,1408,1418,1079,1385,1623,1547,1101,47,73,47073,3859,4648,8041,5304,3630,4754,8583,6331,7489,9402,16624,11635,56611,27657,28954,54363,747,299,123,878,41924,11693,20774.0,24776.0
3173,"Johnson County, Tennessee",9593,412,294,266,319,398,451,264,47,91,47091,1368,2068,2736,1859,900,1306,2409,2113,2268,3374,5145,3972,17753,9593,8160,16694,613,85,36,361,36004,4019,6579.0,7793.0
3174,"Lincoln County, Tennessee",16669,943,890,765,891,842,1327,567,47,103,47103,2333,2873,4731,2772,2151,2874,4973,3630,4484,5747,9704,6402,33924,16669,17255,30413,2428,195,57,1192,49485,6469,13348.0,15575.0
3175,"Macon County, Tennessee",11738,822,707,456,865,792,743,429,47,111,47111,1747,2107,3291,1627,1847,2124,3199,2105,3594,4231,6490,3732,23842,11738,12104,22796,44,113,279,1231,37430,4298,7504.0,9486.0
3176,"Moore County, Tennessee",3217,233,191,159,108,205,158,93,47,127,47127,361,581,947,608,430,530,938,699,791,1111,1885,1307,6378,3217,3161,5919,140,153,0,14,57708,1510,2926.0,3539.0
3177,"Robertson County, Tennessee",34747,2306,2420,1495,2117,2108,2572,1557,47,147,47147,5097,6755,9585,4655,4871,6852,9922,5534,9968,13607,19507,10189,70280,34747,35533,61489,5110,391,1472,4873,63307,13677,27113.0,33712.0
3178,"Franklin County, Tennessee",20463,1146,1301,839,956,1044,1193,874,47,51,47051,3576,3366,5416,3696,3541,3399,5836,4419,7117,6765,11252,8115,41725,20463,21262,37735,1988,185,410,1415,51585,8837,16404.0,19146.0
3179,"Blount County, Tennessee",63046,3340,3682,2612,3171,3446,3910,2474,47,9,47009,9229,11029,17669,11587,9005,11338,19153,14384,18234,22367,36822,25971,129927,63046,66881,121965,3461,1042,425,4378,56667,27341,52208.0,66306.0
3180,"Cheatham County, Tennessee",20034,1161,1352,887,1018,1107,1368,800,47,21,47021,2933,3854,5922,2710,2652,3958,6089,3155,5585,7812,12011,5865,40181,20034,20147,37993,637,184,438,1204,61913,8594,15924.0,20091.0
3181,"Carter County, Tennessee",27576,1246,1492,1023,1254,1164,1843,903,47,19,47019,3786,4975,8005,5416,3680,4956,8521,6536,7466,9931,16526,11952,56433,27576,28857,54369,967,254,118,1055,38092,12068,21084.0,24868.0
3182,"Grainger County, Tennessee",11585,583,655,499,531,641,636,433,47,57,47057,1531,2023,3365,2203,1414,1885,3524,2452,2945,3908,6889,4655,23101,11585,11516,22474,104,64,1,772,44064,4472,8008.0,10123.0
3183,"Giles County, Tennessee",14316,977,653,506,716,840,871,551,47,55,47055,2053,2303,4237,2588,2106,2306,4357,3222,4159,4609,8594,5810,29285,14316,14969,25222,2871,65,248,741,49614,5792,11137.0,13202.0
3184,"Lauderdale County, Tennessee",13340,762,717,581,731,950,728,513,47,97,47097,2376,2882,3313,1715,1767,2315,3389,2256,4143,5197,6702,3971,25989,13340,12649,16359,8769,72,51,661,39896,3789,8087.0,8963.0
3185,"Lawrence County, Tennessee",21251,1527,1700,960,1466,1486,1465,907,47,99,47099,3086,3566,5624,3398,3053,3685,5823,4254,6139,7251,11447,7652,43390,21251,22139,41314,724,226,223,969,43614,8498,15666.0,18718.0
3186,"Madison County, Tennessee",46221,3125,2657,1892,2925,2715,3270,1951,47,113,47113,8013,8141,11948,6952,8857,8859,13774,9053,16870,17000,25722,16005,97625,46221,51404,56534,36352,1054,1586,3765,48161,17141,38120.0,42847.0
3187,"Marion County, Tennessee",13878,865,866,540,779,704,955,531,47,115,47115,1974,2393,3943,2500,1961,2449,4202,3079,3935,4842,8145,5579,28538,13878,14660,26529,734,136,156,517,49432,5319,10862.0,13204.0
3188,"Overton County, Tennessee",10863,681,694,449,514,722,624,428,47,133,47133,1556,1780,2946,2017,1500,1837,3164,2416,3056,3617,6110,4433,22068,10863,11205,21520,144,99,6,327,37197,4778,8229.0,10025.0
3189,"Pickett County, Tennessee",2563,108,120,144,117,95,155,43,47,137,47137,277,369,731,665,272,377,757,700,549,746,1488,1365,5079,2563,2516,5054,9,0,0,19,39554,1035,2615.0,2922.0
3190,"Wayne County, Tennessee",9172,427,477,313,395,390,330,258,47,181,47181,1600,1992,2494,1409,889,1327,2221,1711,2489,3319,4715,3120,16693,9172,7521,15258,1143,132,52,348,41427,3456,5857.0,6667.0
3191,"Williamson County, Tennessee",110242,6814,9001,5879,6622,8957,9007,5936,47,187,47187,13453,21268,31146,13110,13023,23109,32912,15581,26476,44377,64058,28691,225389,110242,115147,200077,9281,9495,958,10748,112962,56322,106271.0,139640.0
3192,"Bedford County, Tennessee",23834,1614,1558,1132,1597,1464,2006,938,47,3,47003,3805,4427,6077,3245,3600,4532,6307,4014,7405,8959,12384,7259,48292,23834,24458,41129,3908,96,1947,5987,50415,9091,15355.0,19039.0
3193,"Greene County, Tennessee",33654,1704,1780,1294,1541,1368,2266,1293,47,59,47059,4909,5820,9510,6518,4603,5947,10113,8049,9512,11767,19623,14567,68834,33654,35180,65096,1501,273,496,1989,42595,14809,23583.0,28057.0
3194,"Cumberland County, Tennessee",28973,1360,1641,866,1429,1641,1193,851,47,35,47035,3634,3911,7458,8570,3288,4242,8270,9329,6922,8153,15728,17899,59216,28973,30243,57133,613,209,162,1770,45958,12111,26360.0,32307.0
3195,"Van Buren County, Tennessee",2898,155,118,96,153,124,147,100,47,175,47175,359,477,888,614,315,481,860,682,674,958,1748,1296,5760,2898,2862,5545,16,0,9,41,42724,1212,2419.0,2917.0
3196,"Claiborne County, Tennessee",15406,802,758,550,861,870,726,525,47,25,47025,2583,2754,4276,2752,2684,2612,4648,3400,5267,5366,8924,6152,31732,15406,16326,30581,321,247,16,419,36835,6822,10740.0,12935.0
3197,"Hickman County, Tennessee",13034,702,585,560,653,497,864,505,47,81,47081,2174,2565,3651,1902,1601,2056,3330,2273,3775,4621,6981,4175,24813,13034,11779,22891,1299,94,26,611,43596,4767,7813.0,9832.0
3198,"Humphreys County, Tennessee",8949,494,568,356,433,456,669,304,47,85,47085,1313,1510,2502,1606,1302,1648,2724,1950,2615,3158,5226,3556,18435,8949,9486,17271,430,129,27,455,45667,4044,7153.0,8232.0
3199,"Putnam County, Tennessee",38268,2103,1950,1490,2357,2080,2235,1352,47,141,47141,8896,6709,8907,5615,7701,6592,9646,7216,16597,13301,18553,12831,77447,38268,39179,72255,1720,1009,697,4838,44259,15831,27212.0,33481.0
3200,"Sevier County, Tennessee",47695,2776,2812,1832,2458,2407,2867,1732,47,155,47155,7353,8313,13193,8405,6836,8341,14449,10283,14189,16654,27642,18688,97068,47695,49373,91964,910,759,998,5818,49610,19035,36312.0,43574.0
3201,"Stewart County, Tennessee",6612,364,455,261,452,271,408,252,47,161,47161,914,1069,1939,1209,859,1130,2020,1423,1773,2199,3959,2632,13427,6612,6815,12572,134,96,92,406,45809,3080,5299.0,6283.0
3202,"Chester County, Tennessee",8276,593,457,341,510,313,713,367,47,23,47023,1638,1322,2054,1290,1693,1440,2262,1616,3331,2762,4316,2906,17190,8276,8914,14794,1535,78,352,452,51946,3032,6507.0,7578.0
3203,"Decatur County, Tennessee",5730,346,407,234,280,318,379,197,47,39,47039,717,862,1606,1215,639,978,1641,1524,1356,1840,3247,2739,11686,5730,5956,10780,518,0,26,169,42031,2479,4592.0,5250.0
3204,"Jackson County, Tennessee",5872,260,255,225,241,319,258,189,47,87,47087,805,933,1782,1248,725,981,1780,1317,1530,1914,3562,2565,11682,5872,5810,11177,40,5,181,244,35207,2391,4466.0,5308.0
3205,"McNairy County, Tennessee",12548,689,760,528,736,786,788,528,47,109,47109,1803,2101,3431,2371,1711,2195,3593,2959,3514,4296,7024,5330,25844,12548,13296,23639,1428,54,105,545,39161,5209,10038.0,11267.0
3206,"Roane County, Tennessee",26124,1324,1477,1019,1098,1249,1419,1002,47,145,47145,3396,4195,7816,5472,3390,4273,8199,6321,6786,8468,16015,11793,53075,26124,26951,49748,1227,418,264,980,53367,10668,21669.0,25914.0
3207,"Bradley County, Tennessee",51468,3057,3434,2236,2997,3196,3172,2057,47,11,47011,8582,9597,13583,7774,8833,9822,14192,10012,17415,19419,27775,17786,105749,51468,54281,95001,5358,1277,1914,6541,51331,19519,38666.0,45968.0
3208,"Hamblen County, Tennessee",31457,2068,2244,1317,1844,1845,2362,1269,47,63,47063,4687,5686,8487,4979,4332,5747,8788,6488,9019,11433,17275,11467,64132,31457,32675,56703,2964,562,1945,7508,43619,12033,20692.0,24625.0
3209,"Union County, Tennessee",9616,514,637,386,511,535,664,370,47,173,47173,1313,1694,2781,1663,1271,1744,2904,1873,2584,3438,5685,3536,19488,9616,9872,19021,98,54,37,326,44671,3805,6247.0,8096.0
3210,"Hardin County, Tennessee",12519,725,644,594,581,655,889,466,47,71,47071,1722,1918,3524,2631,1569,2180,3716,3140,3291,4098,7240,5771,25715,12519,13196,24251,1001,119,20,657,40682,5407,9949.0,11534.0
3211,"Dickson County, Tennessee",25998,1756,1475,1211,1449,1653,1677,984,47,43,47043,3796,4832,7129,3671,3666,5159,7587,4507,7462,9991,14716,8178,52680,25998,26682,48792,2213,264,183,1885,53076,10223,18699.0,24342.0
3212,"Morgan County, Tennessee",11783,532,472,396,517,368,776,397,47,129,47129,2059,2523,3311,1771,1244,1636,2838,1986,3303,4159,6149,3757,21545,11783,9762,20010,1239,11,70,287,41333,4598,6705.0,8218.0
3213,"Monroe County, Tennessee",22679,1303,1346,865,1354,1300,1308,979,47,123,47123,3152,3859,6285,4403,3062,3782,6483,5117,6214,7641,12768,9520,46064,22679,23385,43415,961,185,416,2029,42429,8582,17093.0,20749.0
3214,"Henry County, Tennessee",15498,774,1021,595,939,859,1071,581,47,79,47079,2043,2560,4373,3277,1924,2621,4719,4072,3967,5181,9092,7349,32284,15498,16786,28754,2643,127,165,839,40502,6774,12945.0,15034.0
3215,"Crockett County, Tennessee",6834,440,474,299,432,486,600,255,47,33,47033,975,1225,1819,1144,987,1331,1936,1538,1962,2556,3755,2682,14399,6834,7565,11447,1877,48,679,1521,44717,2522,5397.0,6114.0
3216,"Lake County, Tennessee",4641,147,177,114,172,150,103,105,47,95,47095,1038,1257,1330,485,354,403,814,659,1392,1660,2144,1144,7401,4641,2760,4997,2110,18,112,172,35191,1420,1970.0,2034.0
3217,"Knox County, Tennessee",224184,13584,13846,8456,12881,13192,13453,8144,47,93,47093,44030,43103,56459,30790,43523,44796,60527,40404,87553,87899,116986,71194,461104,224184,236920,394105,40147,10114,4890,19707,57470,97303,180697.0,219869.0
3218,"Benton County, Washington",98762,7071,7989,4454,6994,7737,6852,4313,53,5,53005,15381,19343,23738,13318,14545,18775,24204,15336,29926,38118,47942,28654,197518,98762,98756,162240,3198,5069,17639,42849,69023,34200,80027.0,101066.0
3219,"Clark County, Washington",233959,15172,16120,10434,14020,16576,15491,10007,53,11,53011,35815,46359,60593,32384,33977,47595,62848,38779,69792,93954,123441,71163,473252,233959,239293,400298,8409,21752,12214,45528,75253,88716,200160.0,270039.0
